'CAUSE	K AH Z
1.77245385.	W AH N S EH V AH N S EH V AH N T UW F OW R F AY V TH R IY EY T F AY V
1936,	W AH N AY N TH R IY S IH K S
1995	W AH N AY N AY N F AY V
2003	T UW Z IY R OW Z IY R OW TH R IY
2006.	T UW Z IY R OW Z IY R OW S IH K S
3D.	TH R IY D IY
A	AH
A(2)	EY
A!	AH
A'S	EY Z
A,	AH
A-A-AND	EY EY AH N D
A-ALL	EY AO L
A-AND	EY AH N D
A-AND,	EY AE N D
A-ARE	EY AA R
A-AT	EY AE T
A-HO,	EY HH OW
A.	EY
AAAAAAAAAAAAAAAAAH!	AH AH AH AA AH AH AA AH AH
AAAAAAAAAAAAAH!	AH AA AH AH AA AH AH
AAAAAAAH!	AA AA AH AH
AAAAH!	AA AH
AAH!	AA
ABANDONING	AH B AE N D AH N IH NG
ABDUCTED,	AH B D AH K T IH D
ABDUCTIONS	AE B D AH K SH AH N Z
ABDUCTIONS(2)	AH B D AH K SH AH N Z
ABIDE	AH B AY D
ABLE	EY B AH L
ABLED.	EY B AH L D
ABORTION,	AH B AO R SH AH N
ABORTION?	AH B AO R SH AH N
ABOUT	AH B AW T
ABOUT!	AH B AW T
ABOUT,	AH B AW T
ABOUT.	AH B AW T
ABOUT?	AH B AW T
ABOVE	AH B AH V
ABOVE.	AH B AH V
ABSOLUTELY	AE B S AH L UW T L IY
ACADEMY	AH K AE D AH M IY
ACCELERATED	AE K S EH L ER EY T IH D
ACCEPT	AE K S EH P T
ACCEPT(2)	AH K S EH P T
ACCEPTED.	AE K S EH P T IH D
ACCESS	AE K S EH S
ACCIDENT	AE K S AH D AH N T
ACCIDENT.	AE K S AH D AH N T
ACCIDENTALLY	AE K S AH D EH N T AH L IY
ACCIDENTALLY(2)	AE K S AH D EH N AH L IY
ACCOMPLISH	AH K AA M P L IH SH
ACCOMPLISHED	AH K AA M P L IH SH T
ACCORDINGLY	AH K AO R D IH NG L IY
ACCOUNTANT,	AH K AW N T AH N T
ACCURATE	AE K Y ER AH T
ACHIEVED	AH CH IY V D
ACID.	AE S AH D
ACQUIRE	AH K W AY ER
ACQUIRED	AH K W AY ER D
ACQUISITION	AE K W AH Z IH SH AH N
ACQUISITIONS!	AE K W AH Z IH SH AH N Z
ACROSS	AH K R AO S
ACT	AE K T
ACTING	AE K T IH NG
ACTING.	AE K T IH NG
ACTION.	AE K SH AH N
ACTIVE	AE K T IH V
ACTOR	AE K T ER
ACTUAL	AE K CH AH W AH L
ACTUAL(2)	AE K SH AH L
ACTUALLY	AE K CH UW AH L IY
ACTUALLY(2)	AE K CH L IY
ACTUALLY(3)	AE K SH AH L IY
ACTUALLY,	AE K CH AH W AH L IY
ACTUALLY.	AE K CH AH W AH L IY
AD	AE D
ADAGE	AE D AH JH
ADAM	AE D AH M
ADAM.	AE D AH M
ADD	AE D
ADMIT	AH D M IH T
ADMIT,	AH D M IH T
ADULT	AH D AH L T
ADULT(2)	AE D AH L T
ADULTS	AH D AH L T S
ADULTS(2)	AE D AH L T S
ADVANCED	AH D V AE N S T
ADVANCED,	AH D V AE N S T
ADVENTURE	AE D V EH N CH ER
ADVENTURE(2)	AH D V EH N CH ER
ADVENTURE!	AH D V EH N CH ER
ADVENTURE'S	AE D V EH N CH ER Z
ADVENTURE,	AH D V EH N CH ER
ADVENTURE.	AH D V EH N CH ER
ADVENTURE?	AH D V EH N CH ER
ADVENTURES	AE D V EH N CH ER Z
ADVENTURES!	AH D V EH N CH ER Z
ADVENTURES,	AH D V EH N CH ER Z
ADVENTURES.	AH D V EH N CH ER Z
ADVENTURES?	AH D V EH N CH ER Z
ADVENTUROUSLY.	AH D V EH N CH ER AH S L IY
ADVICE	AE D V AY S
ADVICE(2)	AH D V AY S
ADVISE	AE D V AY Z
ADVISE(2)	AH D V AY Z
ADVOCACY	AE D V AH K AH S IY
AFFAIR	AH F EH R
AFRAID	AH F R EY D
AFRICAN	AE F R IH K AA N
AFTER	AE F T ER
AFTER,	AE F T ER
AFTERNOON?	AE F T ER N UW N
AFTERSHAVE	AE F T ER SH EY V
AFTERWARDS!	AE F T ER W ER D Z
AFTERWARDS.	AE F T ER W ER D Z
AGAIN	AH G EH N
AGAIN(2)	AH G EY N
AGAIN!	AH G EH N
AGAIN,	AH G EH N
AGAIN.	AH G EH N
AGAIN?	AH G EH N
AGAINST	AH G EH N S T
AGAINST(2)	AH G EY N S T
AGE	EY JH
AGE,	EY JH
AGE.	EY JH
AGENCY	EY JH AH N S IY
AGENCY.	EY JH AH N S IY
AGES.	EY JH IH Z
AGGRESSIVE	AH G R EH S IH V
AGGRESSIVE,	AH G R EH S IH V
AGGRESSIVELY	AH G R EH S IH V L IY
AGING	EY JH IH NG
AGO,	AH G OW
AGREE	AH G R IY
AGREE.	AH G R IY
AH!	AA
AH,	AA
AHA!	AE HH AH
AHEAD	AH HH EH D
AHEAD.	AH HH EH D
AHEM.	AH HH EH M
AHH.	AE HH
AIDS.	EY D Z
AIM,	EY M
AIN'T	EY N T
AIR	EH R
AIR-NESS	EH R N EH S
AIRBORNE,	AH IH R B AO R N
AIRFLOW	EH R F L OW
AKA	AA K AH
AKA(2)	EY K EY EY
AKBAR!	AE K B AH R
AL-QAEDA,	AE L K IY D AH
ALABAMA	AE L AH B AE M AH
ALBERT	AE L B ER T
ALCOHOLISM.	AE L K AH HH AO L IH Z AH M
ALEJANDRO	AA L EY Y AA N D R OW
ALEJANDRO(2)	AA L EY HH AA N D R OW
ALEJANDRO,	AE L AH JH AE N D R OW
ALERT!	AH L ER T
ALEXAND	AH L EH K S AH N D
ALIEN	EY L IY AH N
ALIEN?	EY L IY AH N
ALIENS	EY L IY AH N Z
ALIVE	AH L AY V
ALIVE.	AH L IH V
ALIVE?	AH L IH V
ALL	AO L
ALL,	AO L
ALL.	AO L
ALLAHU	AE L AH HH UW
ALLEVIATE	AH L IY V IY EY T
ALLOW	AH L AW
ALLOWED	AH L AW D
ALLOWS	AH L AW Z
ALMOST	AO L M OW S T
ALONE	AH L OW N
ALONE!	AH L OW N
ALONE,	AH L OW N
ALONE.	AH L OW N
ALONG	AH L AO NG
ALREADY	AO L R EH D IY
ALREADY(2)	AO R EH D IY
ALREADY!	AO L R EH D IY
ALREADY.	AO L R EH D IY
ALSO	AO L S OW
ALSO,	AO L S OW
ALTERING	AO L T ER IH NG
ALTERNATE	AO L T ER N AH T
ALTERNATE(2)	AO L T ER N EY T
ALWAYS	AO L W EY Z
ALWAYS(2)	AO L W IY Z
AM	AE M
AM(2)	EY EH M
AM.	AE M
AM?	AE M
AMAZING	AH M EY Z IH NG
AMAZING.	AH M EY Z IH NG
AMAZON	AE M AH Z AA N
AMBITIOUS,	AE M B IH SH AH S
AMERICA,	AH M EH R AH K AH
AMERICAN	AH M EH R IH K AH N
AMOUNT	AH M AW N T
AMPLIFIER,	AE M P L AH F AY ER
AMUSEMENT	AH M Y UW Z M AH N T
AN	AE N
AN(2)	AH N
ANAL	EY N AH L
ANATOMY	AH N AE T AH M IY
AND	AH N D
AND(2)	AE N D
AND,	AE N D
ANDERSON,	AE N D AH R S AH N
ANDERSON.	AE N D AH R S AH N
ANDROMEDA	AE N D R AA M AH D AH
ANDUM	AE N D AH M
ANDWE'RE	AE N D W AH R
ANDWHEN	AE N D W AH N
ANGEL'S	EY N JH AH L Z
ANGELES.	AE N JH AH L AH S
ANGER	AE NG G ER
ANGRY	AE NG G R IY
ANIMALS	AE N AH M AH L Z
ANIMALS!	AE N AH M AH L Z
ANIMATRONIC	AE N AH M AE T R AH N AH K
ANN	AE N
ANNIE.	AE N AY
ANNOUNCEMENT	AH N AW N S M EH N T
ANNUAL	AE N Y UW AH L
ANOTHER	AH N AH DH ER
ANOTHER.	AH N AH DH ER
ANSWER	AE N S ER
ANSWER'S	AE N S ER Z
ANSWER.	AE N S ER
ANSWERS.	AE N S ER Z
ANTI-PLANET	AE N T IY P L AE N AH T
ANTICIPATED.	AE N T IH S AH P EY T IH D
ANTIDOTE.	AE N T IH D OW T
ANTILOCK	AE N T IY L AA K
ANTILOCK(2)	AE N T AY L AA K
ANTIQUE	AE N T IY K
ANTS	AE N T S
ANXIETY	AE NG Z AY AH T IY
ANY	EH N IY
ANYBODY	EH N IY B AH D IY
ANYBODY,	EH N IY B AA D IY
ANYMORE!	EH N IY M OW R
ANYMORE,	EH N IY M OW R
ANYMORE.	EH N IY M OW R
ANYONE	EH N IY W AH N
ANYONE!	EH N IY W AH N
ANYTHING	EH N IY TH IH NG
ANYTHING,	EH N IY TH IH NG
ANYTHING.	EH N IY TH IH NG
ANYTHING?	EH N IY TH IH NG
ANYWAY!	EH N IY W EY
ANYWAY,	EH N IY W EY
ANYWAYS.	EH N IY W EY Z
ANYWAYS?	EH N IY W EY Z
ANYWHERE.	EH N IY W EH ER
APART!	AH P AA R T
APART,	AH P AA R T
APARTMENTS	AH P AA R T M AH N T S
APPARENT	AH P EH R AH N T
APPARENTLY,	AH P AE R AH N T L IY
APPEARS	AH P IH R Z
APPLE	AE P AH L
APPLE-RELATED	AE P AH L R IH L EY T IH D
APPLES	AE P AH L Z
APPLES,	AE P AH L Z
APPLES?	AE P AH L Z
APPLEY	AE P AH L IY
APPOINTMENT	AH P OY N T M AH N T
APPOINTMENT,	AH P OY N T M AH N T
APPRECIATE	AH P R IY SH IY EY T
APPROVAL?	AH P R UW V AH L
APRON	EY P R AH N
APRON.	EY P R AH N
AR-ARSENIO.	AA R AA R S IY N IY OW
ARE	AA R
ARE(2)	ER
ARE,	AA R
ARE.	AA R
AREN'T	AA R AH N T
AREN'T(2)	AA R N T
AREOLA,	AH R IY AH L AH
AREYOU?	AE R EY UW
ARGENTINA.	AA R JH EH N T AH N AH
ARM	AA R M
ARM.	AA R M
ARMADA	AA R M AA D AH
ARMED.	AA R M D
ARMING	AA R M IH NG
ARMS	AA R M Z
ARMS.	AA R M Z
ARMY	AA R M IY
AROUND	ER AW N D
AROUND(2)	ER AW N
AROUND,	AH R AW N D
AROUND.	AH R AW N D
ARRESTED,	AH R EH S T IH D
ARRIVED	ER AY V D
ARRIVING	ER AY V IH NG
ARSENIO	AA R S IY N IY OW
ART	AA R T
ARTERIAL	AA R T IH R IY AH L
ARTISTS.	AA R T IH S T S
AS	AE Z
AS(2)	EH Z
ASHAMED	AH SH EY M D
ASIDE	AH S AY D
ASK	AE S K
ASK,	AE S K
ASK.	AE S K
ASKED	AE S K T
ASKED(2)	AE S T
ASKED,	AE S K T
ASKING	AE S K IH NG
ASKING,	AE S K IH NG
ASKING.	AE S K IH NG
ASLEEP	AH S L IY P
ASPECT	AE S P EH K T
ASS,	AE S
ASS.	AE S
ASSAULT	AH S AO L T
ASSEMBLE	AH S EH M B AH L
ASSERTIVE.	AH S ER T IH V
ASSHOLE.	AE S HH OW L
ASSHOLES	AE S HH OW L Z
ASSUME	AH S UW M
ASTEROID	AE S T ER OY D
AT	AE T
AT,	AE T
ATHLETIC	AE TH L EH T IH K
ATLAS!	AE T L AH S
ATLAS?	AE T L AH S
ATTACK	AH T AE K
ATTACKED	AH T AE K T
ATTENDED	AH T EH N D AH D
ATTENTION	AH T EH N SH AH N
ATTENTION.	AH T EH N CH AH N
ATTRACTION	AH T R AE K SH AH N
ATTRACTION,	AH T R AE K SH AH N
ATTRACTIONS.	AH T R AE K SH AH N Z
ATTRACTIVE	AH T R AE K T IH V
AUTHOR,	AO TH ER
AUTO	AO T OW
AUTO,	AO T OW
AUTOBIOGRAPHICAL?	AO T AH B AY AH G R AE F IH K AH L
AUTOPILOT.	AO T OW P AY L AH T
AVOID	AH V OY D
AW!	AO
AW,	AO
AWARD	AH W AO R D
AWARD-WINNING	AH W AO R D W IH N IH NG
AWARE	AH W EH R
AWARENESS	AH W EH R N AH S
AWARENESS,	AH W EH R N AH S
AWAY	AH W EY
AWAY!	AH W EY
AWAY.	AH W EY
AWESOME.	AO S AH M
AWESOMENESS,	AO S AH M N AH S
AWW!	AO W
AWW,	AO W
AWW.	AO W
AXLE?	AE K S AH L
B	B IY
B-BACK	B IY B AE K
B-BRILLIANT.	B IY B R IH L Y AH N T
B-BUT	B IY B AH T
B-BYE.	B IY B AY
B-O-O-O-Y	B IY OW OW OW W AY
BA	B AA
BABIES	B EY B IY Z
BABIES,	B EY B IY Z
BABIES.	B EY B IY Z
BABY	B EY B IY
BABY!	B EY B IY
BABY.	B EY B IY
BABYLEGS	B EY B IY L EH G Z
BABYLEGS,	B EY B IY L EH G Z
BABYLEGS.	B EY B IY L EH G Z
BACK	B AE K
BACK!	B AE K
BACK,	B AE K
BACK.	B AE K
BACK?	B AE K
BACK?!	B AE K
BACKED	B AE K T
BACKPACK?	B AE K P AE K
BACKUP	B AE K AH P
BACKWARD	B AE K W ER D
BACTERIA,	B AE K T IH R IY AH
BAD	B AE D
BAD!	B AE D
BAD,	B AE D
BAD.	B AE D
BAIL	B EY L
BAILED	B EY L D
BAILING	B EY L IH NG
BALDING	B AO L D IH NG
BALL	B AO L
BALL-THROWING	B AO L TH R OW IH NG
BALL.	B AO L
BALLS	B AO L Z
BAND-AID	B AE N D EY D
BANGING	B AE NG IH NG
BANGS	B AE NG Z
BANGS.	B AE NG Z
BAR	B AA R
BARELY	B EH R L IY
BARGAIN,	B AA R G AH N
BASED	B EY S T
BASICALLY	B EY S IH K L IY
BASIS.	B EY S AH S
BASKETS	B AE S K AH T S
BATH.	B AE TH
BATHROOM,	B AE TH R UW M
BATHROOM.	B AE TH R UW M
BAWK,	B AO K
BAWK.	B AO K
BAY	B EY
BAY.	B EY
BE	B IY
BE!	B IY
BE,	B IY
BE?	B IY
BEAN	B IY N
BEAN'S	B IY N Z
BEAN.	B IY N
BEAST	B IY S T
BEAT,	B IY T
BEAT.	B IY T
BEATING	B IY T IH NG
BEAUTIFUL	B Y UW T AH F AH L
BEAUTIFUL,	B Y UW T IY F AH L
BEAUTIFUL.	B Y UW T IY F AH L
BEAUTY	B Y UW T IY
BECAME	B IH K EY M
BECAME(2)	B IY K EY M
BECAUSE	B IH K AO Z
BECAUSE(2)	B IH K AH Z
BECAUSE(3)	B IH K AA Z
BECAUSE,	B IH K AO Z
BECOME	B IH K AH M
BECOMES	B IH K AH M Z
BEDROCK	B EH D R AA K
BEDROOM	B EH D R UW M
BEDTIME	B EH D T AY M
BEEN	B IH N
BEEN(2)	B AH N
BEEN.	B IH N
BEEPING,	B IY P IH NG
BEEPS!	B AH EH P S
BEFORE	B IH F AO R
BEFORE(2)	B IY F AO R
BEFORE.	B IH F OW R
BEFORE?	B IH F OW R
BEG	B EH G
BEGIN	B IH G IH N
BEGINNER'S	B IH G IH N ER Z
BEGINNING	B IH G IH N IH NG
BEGINNING,	B IH G IH N IH NG
BEGINS	B IH G IH N Z
BEHAVIOR.	B IH HH EY V Y ER
BEHIND	B IH HH AY N D
BEHIND-EVERY-GREAT-MAN	B IH HH AY N D EH V ER IY G R EY T M AE N
BEHIND.	B IH HH AY N D
BEHIND?	B IH HH AY N D
BEING	B IY IH NG
BEING,	B IY IH NG
BELIEVE	B IH L IY V
BELIEVE,	B AH L IY V
BELIEVE.	B AH L IY V
BELL	B EH L
BELONG	B IH L AO NG
BELONGS	B IH L AO NG Z
BELOVED	B IH L AH V D
BELOVED(2)	B IH L AH V AH D
BELOW	B IH L OW
BELOW(2)	B IY L OW
BELOW,	B IH L OW
BELUSHIS	B IH L AH SH IY Z
BEND	B EH N D
BENEATH	B IH N IY TH
BENNETT,	B IH N EH T
BEST	B EH S T
BEST,	B EH S T
BEST-SELLING	B EH S T S EH L IH NG
BEST.	B EH S T
BESTSELLING	B EH S T S EH L IH NG
BESTSELLING(2)	B EH S EH L IH NG
BET	B EH T
BET,	B EH T
BET.	B EH T
BETH	B EH TH
BETH!	B IY IH TH
BETH,	B IY IH TH
BETH.	B IY IH TH
BETH?	B IY IH TH
BETTER	B EH T ER
BETTER,	B EH T ER
BETTER.	B EH T ER
BETWEEN	B IH T W IY N
BETWEEN(2)	B IY T W IY N
BEYOND	B IH AA N D
BEYOND(2)	B IY AO N D
BEYOND(3)	B IH AO N D
BIASED,	B AY AH S T
BIDDER	B IH D ER
BIG	B IH G
BIG,	B IH G
BIGGER	B IH G ER
BILL	B IH L
BILL?	B IH L
BILLION	B IH L Y AH N
BILLY.	B IH L IY
BIOLOGICAL	B AY AH L AA JH IH K AH L
BIRDIE	B ER D IY
BIRDIE.	B ER D IY
BIRDS.	B ER D Z
BIRTHING	B ER TH IH NG
BIT	B IH T
BIT,	B IH T
BIT.	B IH T
BIT?	B IH T
BITCH	B IH CH
BITCH!	B IH CH
BITCH,	B IH CH
BITCH.	B IH CH
BITCH?	B IH CH
BITCHES!	B IH CH IH Z
BITE.	B AY T
BITES	B AY T S
BITTER	B IH T ER
BLACK	B L AE K
BLACK.	B L AE K
BLADDER	B L AE D ER
BLAME	B L EY M
BLAME!	B L EY M
BLANK	B L AE NG K
BLAST.	B L AE S T
BLEEDING	B L IY D IH NG
BLEND.	B L EH N D
BLEW	B L UW
BLIMFARX,	B L IH M F AH R K S
BLIND	B L AY N D
BLIND?	B L AY N D
BLOCK	B L AA K
BLOCKAGE.	B L AA K IH JH
BLOOD	B L AH D
BLOOD!	B L AH D
BLOOD,	B L AH D
BLOOD.	B L AH D
BLOOGIES,	B L UW JH AY Z
BLOOM	B L UW M
BLOOM'S	B L UW M Z
BLOOM,	B L UW M
BLOOM.	B L UW M
BLOOM?	B L UW M
BLOW	B L OW
BOARD-DRIVEN.	B AO R D D R IH V AH N
BOB	B AA B
BOBBY	B AA B IY
BODIES.	B AA D IY Z
BODY	B AA D IY
BODY,	B AA D IY
BODY.	B AA D IY
BOLD	B OW L D
BOMB	B AA M
BOMB(2)	B AO M
BOMB,	B AA M
BOMB.	B AA M
BOMB?!	B AA M
BOMBED	B AA M D
BOND.	B AA N D
BONE	B OW N
BONUS-GIVING	B OW N AH S G IH V IH NG
BOO-YAH!	B UW Y AE
BOOBIES	B UW B IY Z
BOOBIES.	B UW B IY Z
BOOBS.	B UW B Z
BOOBY	B UW B IY
BOOK	B UH K
BOOM!	B UW M
BOOM.	B UW M
BOPS!	B AA P S
BORED.	B AO R D
BORING	B AO R IH NG
BORING.	B AO R IH NG
BORN	B AO R N
BORN.	B AO R N
BOSS	B AA S
BOSS(2)	B AO S
BOSS?	B AO S
BOTH	B OW TH
BOTH!	B OW TH
BOTH.	B OW TH
BOTHERED	B AA DH ER D
BOTHERING	B AA DH ER IH NG
BOTTLE	B AA T AH L
BOTTLED	B AA T AH L D
BOTTOM	B AA T AH M
BOUGHT	B AA T
BOUGHT(2)	B AO T
BOULDER	B OW L D ER
BOULDER?!	B OW L D ER
BOUNCE.	B AW N S
BOUNDS	B AW N D Z
BOX	B AA K S
BOX.	B AA K S
BOXES	B AA K S AH Z
BOXES(2)	B AA K S IH Z
BOXES.	B AA K S IH Z
BOXING	B AA K S IH NG
BOY	B OY
BOY!	B OY
BOY,	B OY
BOY.	B OY
BOY?	B OY
BOYFRIEND?	B OY F R EH N D
BRAD	B R AE D
BRAD'S	B R AE D Z
BRAD.	B R AE D
BRADBURY,	B R AE D B EH R IY
BRADLEY!	B R AE D L IY
BRAIN	B R EY N
BRAIN,	B R EY N
BRAINS	B R EY N Z
BRAKES,	B R EY K S
BRAND-NEW	B R AE N D N UW
BRANDON.	B R AE N D AA N
BREAD	B R EH D
BREAK	B R EY K
BREAK.	B R EY K
BREAKDOWN.	B R EY K D AW N
BREAKFAST	B R EH K F AH S T
BREAKFAST,	B R EH K F AH S T
BREAKING	B R EY K IH NG
BREAKTHROUGH.	B R EY K TH R UW
BREATH	B R EH TH
BREATH,	B R EH TH
BREATH.	B R EH TH
BREATHE	B R IY DH
BREED	B R IY D
BREED.	B R IY D
BREEDING	B R IY D IH NG
BREEZE.	B R IY Z
BREW	B R UW
BRIDGE	B R IH JH
BRING	B R IH NG
BRINGING	B R IH NG IH NG
BRO.	B R OW
BROKEN	B R OW K AH N
BROKEN,	B R OW K AH N
BROKEN-LEG	B R OW K AH N L EH G
BRONCHIAL	B R AA N CH IY AH L
BROTHER	B R AH DH ER
BROTHER.	B R AH DH ER
BROTHER?	B R AH DH ER
BROTHERS	B R AH DH ER Z
BROTHERS,	B R AH DH ER Z
BROTHERS.	B R AH DH ER Z
BROTHERTOOK	B R AH DH ER T UH K
BROUGHT	B R AO T
BRUSH	B R AH SH
BUBONIC	B Y UW B AA N IH K
BUCKET	B AH K IH T
BUCKET.	B AH K AH T
BUCKLE	B AH K AH L
BUDDY!	B AH D IY
BUDDY.	B AH D IY
BUDDY?	B AH D IY
BUGS	B AH G Z
BUH-BYE.	B UW B AY
BUILD	B IH L D
BUILDING	B IH L D IH NG
BUILT	B IH L T
BULL	B UH L
BULLCRAP.	B UH L K R AE P
BULLET!	B UH L AH T
BULLET,	B UH L AH T
BULLY	B UH L IY
BUMMER.	B AH M ER
BUMPING	B AH M P IH NG
BUN	B AH N
BUNCH	B AH N CH
BUNDLE	B AH N D AH L
BUNNY	B AH N IY
BUREAUCRACY.	B Y UH R AA K R AH S IY
BUREAUCRATS.	B Y UH R AH K R AE T S
BURIED	B EH R IY D
BURIES	B EH R IY Z
BURN	B ER N
BURNIN'	B AH R N AH N
BURNING	B ER N IH NG
BURNS!	B ER N Z
BURQA	B AH R K AH
BURST	B ER S T
BURST!	B ER S T
BUSHES	B UH SH AH Z
BUSINESS	B IH Z N AH S
BUSINESS(2)	B IH Z N IH S
BUSINESS,	B IH Z N AH S
BUSINESS.	B IH Z N AH S
BUSINESS?	B IH Z N AH S
BUSY	B IH Z IY
BUSY.	B IH Z IY
BUT	B AH T
BUT,	B AH T
BUTT	B AH T
BUTT.	B AH T
BUTT?	B AH T
BUTTER	B AH T ER
BUTTER.	B AH T ER
BUTTHE	B AH T DH
BUTTHOLE	B AH T HH OW L
BUTTHOLE,	B AH T HH OW L
BUTTON	B AH T AH N
BUTTON,	B AH T AH N
BUTTS	B AH T S
BUY	B AY
BUYER.	B AY ER
BY	B AY
BY.	B AY
BYE.	B AY
C	S IY
C!	S IY
C'S.	S IY EH S
C,	S IY
C-CHARACTER,	S IY K AE R IH K T ER
C-CHRISTMAS,	S IY K R IH S T M AH Z
C-COME	S IY K AH M
CABLE	K EY B AH L
CACTUS,	K AE K T AH S
CAESAR.	K EY Z AH R
CAFETERIA	K AE F AH T IH R IY AH
CAKE.	K EY K
CALL	K AO L
CALL.	K AO L
CALLED	K AO L D
CALLED!	K AO L D
CALLED.	K AO L D
CALLING	K AO L IH NG
CALLS	K AO L Z
CALM	K AA M
CALM(2)	K AA L M
CAME	K EY M
CAME.	K EY M
CAMERAS.	K AE M R AH Z
CAMP	K AE M P
CAMPAIGN	K AE M P EY N
CAMPAIGN.	K AE M P EY N
CAMPAIGN?	K AE M P EY N
CAMPAIGNS?	K AE M P EY N Z
CAN	K AE N
CAN(2)	K AH N
CAN'T	K AE N T
CAN'T!	K AE N T
CAN'T,	K AE N T
CAN'T.	K AE N T
CAN'THIDE.	K AE N TH AY D
CAN'TI	K AE N T IY
CAN,	K AE N
CAN.	K AE N
CANCEL	K AE N S AH L
CANCER	K AE N S ER
CANCER,	K AE N S ER
CANNOT	K AE N AA T
CANNOT(2)	K AH N AA T
CAP	K AE P
CAPABLE	K EY P AH B AH L
CAPACITY?	K AH P AE S AH T IY
CAPITAL	K AE P IH T AH L
CAPTURED	K AE P CH ER D
CAPTURES	K AE P CH ER Z
CAR	K AA R
CAR!	K AA R
CARD.	K AA R D
CARE	K EH R
CARE,	K EH R
CARE.	K EH R
CARED	K EH R D
CAREFUL	K EH R F AH L
CAREFUL,	K EH R F AH L
CAREFUL.	K EH R F AH L
CARES	K EH R Z
CARES?	K EH R Z
CARETAKER?	K EH R T EY K ER
CARING.	K EH R IH NG
CARPET!	K AA R P AH T
CARPET,	K AA R P AH T
CARPETS	K AA R P AH T S
CARRY	K AE R IY
CARRY(2)	K EH R IY
CARRY,	K AE R IY
CARS	K AA R Z
CARS(2)	K AA Z
CARTING	K AA R T IH NG
CARTON	K AA R T AH N
CARTOONS	K AA R T UW N Z
CASE	K EY S
CASE,	K EY S
CASH,	K AE SH
CASTLE.	K AE S AH L
CAT	K AE T
CATALOGS	K AE T AH L AO G Z
CATCH	K AE CH
CATCHPHRASE,	K AE CH F R EY Z
CATCHY	K AE CH IY
CATS	K AE T S
CATS!	K AE T S
CATS.	K AE T S
CATWALK,	K AE T W AO K
CAUSE	K AA Z
CAUSE(2)	K AO Z
CAVITY	K AE V AH T IY
CAVITY.	K AE V AH T IY
CC	S IY S IY
CELEBRATING?	S EH L AH B R EY T IH NG
CELEBRATION.	S EH L AH B R EY SH AH N
CELEBRITY,	S AH L EH B R AH T IY
CELESTIAL	S AH L EH S CH AH L
CELLPHONES,	S EH L F OW N Z
CEMENTED	S IH M EH N T IH D
CENTAUR	S EH N T AO R
CENTER	S EH N T ER
CENTER(2)	S EH N ER
CENTRAL	S EH N T R AH L
CENTS	S EH N T S
CENTS(2)	S EH N S
CEREAL	S IH R IY AH L
CEREAL,	S IH R IY AH L
CERTAIN	S ER T AH N
CERTAINLY	S ER T AH N L IY
CERTAINLY.	S ER T AH N L IY
CESIUM	S IY Z IY AH M
CESIUM,	S IY S IY AH M
CESIUM.	S IY S IY AH M
CETERA.	S EH T AH R AH
CH	S IY
CHAIR	CH EH R
CHAMBER	CH EY M B ER
CHAMBER.	CH EY M B ER
CHAMPION	CH AE M P IY AH N
CHANCE	CH AE N S
CHANCE!	CH AE N S
CHANGE	CH EY N JH
CHANGED	CH EY N JH D
CHANNEL	CH AE N AH L
CHANNEL!	CH AE N AH L
CHANNEL.	CH AE N AH L
CHAOTIC	K EY AA T IH K
CHAOTIC!	K EY AA T IH K
CHAPTER	CH AE P T ER
CHARACTER	K EH R IH K T ER
CHARACTER.	K AE R IH K T ER
CHARACTERS.	K AE R IH K T ER Z
CHARGE	CH AA R JH
CHARGE,	CH AA R JH
CHARGE.	CH AA R JH
CHARGING	CH AA R JH IH NG
CHARISMATIC.	CH AA R IH Z AH M AH T IH K
CHASING	CH EY S IH NG
CHAT	CH AE T
CHEAP,	CH IY P
CHEAT	CH IY T
CHECK	CH EH K
CHECK.	CH EH K
CHECKING	CH EH K IH NG
CHECKMATE.	CH EH K M EY T
CHEMICAL	K EH M IH K AH L
CHERRY.	CH EH R IY
CHEWING	CH UW IH NG
CHICKEN	CH IH K AH N
CHICKS,	CH IH K S
CHIEF	CH IY F
CHIEF.	CH IY F
CHILD	CH AY L D
CHILD!	CH AY L D
CHILD.	CH AY L D
CHILDREN	CH IH L D R AH N
CHILDREN!	CH IH L D R AH N
CHILDREN.	CH IH L D R AH N
CHILL.	CH IH L
CHIMPANZEE,	CH IH M P AH N Z IY IY
CHIPS.	CH IH P S
CHOICE.	CH OY S
CHOKE	CH OW K
CHOKING	CH OW K IH NG
CHOOSE	CH UW Z
CHOSE	CH OW Z
CHOSE?	CH OW Z
CHRIS	K R IH S
CHRIST	K R AY S T
CHRIST!	K R AY S T
CHRIST,	K R AY S T
CHRISTMAS	K R IH S M AH S
CHRISTMAS!	K R IH S T M AH Z
CHRISTMAS,	K R IH S T M AH Z
CHRISTMAS.	K R IH S T M AH Z
CHUNKS	CH AH NG K S
CHURRO	CH AH R OW
CHUTES	SH UW T S
CIRCLE	S ER K AH L
CIRCLE.	S ER K AH L
CITIES,	S IH T IY Z
CITIZEN	S IH T AH Z AH N
CITIZEN(2)	S IH T IH Z AH N
CIVICS	S IH V IH K S
CIVIL	S IH V AH L
CLASS	K L AE S
CLASS,	K L AE S
CLASS.	K L AE S
CLASS?	K L AE S
CLASSES	K L AE S AH Z
CLASSES(2)	K L AE S IH Z
CLASSES.	K L AE S IH Z
CLEAN	K L IY N
CLEANING	K L IY N IH NG
CLEAR	K L IH R
CLEAR,	K L IH ER
CLEARLY	K L IH R L IY
CLEVER	K L EH V ER
CLIMATE	K L AY M AH T
CLIMATE(2)	K L AY M IH T
CLINIC.	K L IH N IH K
CLONES	K L OW N Z
CLOSE.	K L OW Z
CLOSET,	K L AA Z AH T
CLOSET.	K L AA Z AH T
CLOTHES	K L OW DH Z
CLOTHES(2)	K L OW Z
CLOTHING	K L OW DH IH NG
CLOUD	K L AW D
CLOUDS	K L AW D Z
CLOUDS!	K L AW D Z
CLOWN	K L AW N
CLOWN.	K L AW N
CLUB!	K L AH B
CLUB,	K L AH B
CLUTTERING	K L AH T ER IH NG
COAST	K OW S T
COAST,	K OW S T
COCAINE	K OW K EY N
COCAINE.	K OW K EY N
CODE	K OW D
COFFEE,	K AO F IY
COGNITION	K AA G N IH SH AH N
COIN	K OY N
COITUS,	K OW AY T AH S
COLD	K OW L D
COLD,	K OW L D
COLI	K OW L IY
COLLAPSE.	K AH L AE P S
COLLECT	K AH L EH K T
COLLECTING	K AH L EH K T IH NG
COLLECTION	K AH L EH K SH AH N
COLLINS'	K AA L IH N Z
COLLISION,	K AH L IH ZH AH N
COLON	K OW L AH N
COLON!	K OW L AH N
COLONIZE	K AA L AH N AY Z
COLOR	K AH L ER
COLOR(2)	K AO L ER
COM	K AA M
COM,	K AA M
COM.	K AA M
COMBINATION,	K AA M B AH N EY SH AH N
COMBINE	K AA M B AY N
COMBINE(2)	K AH M B AY N
COME	K AH M
COME.	K AH M
COMES	K AH M Z
COMFORTABLE,	K AH M F ER T AH B AH L
COMFORTABLY	K AH M F ER T AH B L IY
COMFORTING	K AH M F ER T IH NG
COMIC	K AA M IH K
COMING	K AH M IH NG
COMING!	K AH M IH NG
COMING,	K AH M IH NG
COMING.	K AH M IH NG
COMING?!	K AH M IH NG
COMMERCIAL.	K AH M ER SH AH L
COMMERCIALS	K AH M ER SH AH L Z
COMMERCIALS,	K AH M ER SH AH L Z
COMMIT.	K AH M IH T
COMMITTEE	K AH M IH T IY
COMMUNICATION.	K AH M Y UW N AH K EY SH AH N
COMMUNITY.	K AH M Y UW N AH T IY
COMPANION	K AH M P AE N Y AH N
COMPANY	K AH M P AH N IY
COMPANY.	K AH M P AH N IY
COMPELS	K AH M P EH L Z
COMPETE	K AH M P IY T
COMPILER,	K AH M P AY L ER
COMPLETE	K AH M P L IY T
COMPLETE!	K AH M P L IY T
COMPLETELY	K AH M P L IY T L IY
COMPLICATED	K AA M P L AH K EY T AH D
COMPLIMENTED	K AA M P L AH M EH N T IH D
COMPREHENSION.	K AA M P R IH HH EH N CH AH N
COMPROMISE!	K AA M P R AH M AY Z
COMPUTER	K AH M P Y UW T ER
CON	K AA N
CONCEIVABLE	K AH N S IY V AH B AH L
CONCENTRATE	K AA N S AH N T R EY T
CONCENTRATE.	K AA N S AH N T R EY T
CONCENTRATED	K AA N S AH N T R EY T AH D
CONCENTRATED(2)	K AO N S AH N T R EY T IH D
CONCEPT	K AA N S EH P T
CONCEPTS,	K AA N S EH P T S
CONCEPTUAL	K AH N S EH P CH UW AH L
CONCERTS.	K AH N S ER T S
CONCISE,	K AH N S AY S
CONCLUSION	K AH N K L UW ZH AH N
CONCLUSION,	K AH N K L UW ZH AH N
CONDITIONS	K AH N D IH SH AH N Z
CONDUCTS	K AH N D AH K T S
CONFIDENCE.	K AA N F AH D AH N S
CONFLICT.	K AA N F L IH K T
CONFUSED	K AH N F Y UW Z D
CONFUSED!	K AH N F Y UW Z D
CONFUSED.	K AH N F Y UW Z D
CONFUSING	K AH N F Y UW Z IH NG
CONNECT	K AH N EH K T
CONNECTED	K AH N EH K T IH D
CONNECTING	K AH N EH K T IH NG
CONQUER	K AA NG K ER
CONSECUTIVE	K AH N S EH K Y AH T IH V
CONSIDER	K AH N S IH D ER
CONSIDERED	K AH N S IH D ER D
CONSOLATION,	K AA N S AH L EY SH AH N
CONSTRICT	K AH N S T R IH K T
CONSTRUCTIVE.	K AH N S T R AH K T IH V
CONTAGIOUS	K AH N T EY JH AH S
CONTAIN	K AH N T EY N
CONTAINING	K AH N T EY N IH NG
CONTINENTAL	K AA N T AH N EH N T AH L
CONTINENTAL(2)	K AA N T AH N EH N AH L
CONTINUES	K AH N T IH N Y UW Z
CONTROL	K AH N T R OW L
CONVENIENT?	K AH N V IY N Y AH N T
CONVERSATION	K AA N V ER S EY SH AH N
CONVERSATION.	K AA N V ER S EY SH AH N
CONVICTION.	K AA N V IH K SH AH N
CONVINCING.	K AH N V IH N S IH NG
CONVINCING?	K AH N V IH N S IH NG
COOKIE	K UH K IY
COOKIES?	K UH K IY Z
COOKING	K UH K IH NG
COOL	K UW L
COOL,	K UW L
COOL.	K UW L
COORDINATES	K OW AO R D AH N AH T S
COORDINATES(2)	K OW AO R D AH N EY T S
COPS	K AA P S
CORN	K AO R N
CORN!	K AO R N
CORN?	K AO R N
CORNER	K AO R N ER
CORPORATIONS	K AO R P ER EY SH AH N Z
CORPORATIONS.	K AO R P ER EY SH AH N Z
CORPSE	K AO R P S
CORPSE,	K AO R P S
CORPSE.	K AO R P S
CORRECT!	K AH R EH K T
COUCH?	K AW CH
COUGHING!	K AO F IH NG
COULD	K UH D
COULD.	K UH D
COULDN'T	K UH D AH N T
COULDN'T(2)	K UH D AH N
COUNTER.	K AW N T ER
COUNTERACT	K AW N T ER AE K T
COUNTING	K AW N T IH NG
COUNTRIES	K AH N T R IY Z
COUNTRY	K AH N T R IY
COUNTRY.	K AH N T R IY
COURSE	K AO R S
COURSE.	K OW R S
COURT	K AO R T
COURT!	K OW R T
COURTHOUSE	K AO R T HH AW S
COVER	K AH V ER
COVER,	K AH V ER
COVERAGE	K AH V ER AH JH
COVERAGE(2)	K AH V ER IH JH
COVERAGE(3)	K AH V R IH JH
COW,	K AW
CPR.	S IY P IY AA R
CPU	K P UW
CRAFTSMANSHIP.	K R AE F T S M AE N SH IH P
CRAP	K R AE P
CRAP!	K R AE P
CRAP,	K R AE P
CRAP.	K R AE P
CRAP?	K R AE P
CRAPPED	K R AE P T
CRASH	K R AE SH
CRASHING	K R AE SH IH NG
CRAYONS,	K R EY AA N Z
CRAZY	K R EY Z IY
CRAZY!	K R EY Z IY
CRAZY,	K R EY Z IY
CRAZY?	K R EY Z IY
CREAM	K R IY M
CREAM.	K R IY M
CREAM?	K R IY M
CREATE	K R IY EY T
CREATED	K R IY EY T AH D
CREATED(2)	K R IY EY T IH D
CREATING	K R IY EY T IH NG
CREATIVE	K R IY EY T IH V
CREATIVE.	K R IY EY T IH V
CREATOR	K R IY EY T ER
CREATURE	K R IY CH ER
CREATURES	K R IY CH ER Z
CREEP	K R IY P
CREEP,	K R IY P
CREEPY	K R IY P IY
CREEPY.	K R IY P IY
CRIED	K R AY D
CRIES?	K R AY Z
CRIME	K R AY M
CRIMES	K R AY M Z
CRIMINAL	K R IH M AH N AH L
CRIMINAL.	K R IH M AH N AH L
CRONENBERG	K R OW N AH N B ER G
CRONENBERGED	K R OW N AH N B ER G D
CRONENBERGED.	K R OW N AH N B ER G D
CRONENBERGS	K R OW N AH N B ER G Z
CRONENBERGS!	K R OW N AH N B ER G Z
CROSS	K R AO S
CROWBAR,	K R OW B AA R
CROWBAR.	K R OW B AA R
CROWD	K R AW D
CROWDS,	K R AW D Z
CROWING	K R OW IH NG
CRUCIAL	K R UW SH AH L
CRUEL	K R UW AH L
CRUEL(2)	K R UW L
CRUELTY.	K R UW AH L T IY
CRUSH	K R AH SH
CRUSHES	K R AH SH IH Z
CRY	K R AY
CRYING	K R AY IH NG
CRYSTAL	K R IH S T AH L
CRYSTALLIZED	K R IH S T AH L AY Z D
CUBBIE.	K AH B IY
CUFF	K AH F
CURE	K Y UH R
CURED	K Y UH R D
CURRENCY.	K ER AH N S IY
CURSE	K ER S
CURSE,	K ER S
CURSED	K ER S T
CURSES	K ER S IH Z
CURSES,	K ER S IH Z
CUSTODY	K AH S T AH D IY
CUSTODY,	K AH S T AH D IY
CUSTOMS	K AH S T AH M Z
CUSTOMS,	K AH S T AH M Z
CUT	K AH T
CUTE	K Y UW T
CUTE!	K Y UW T
CUTE,	K Y UW T
CUTE.	K Y UW T
CYBORGS	S AY B AO R G Z
CYCLE,	S AY K AH L
CYNTHIA	S IH N TH IY AH
CYNTHIA.	S IH N TH IY AH
D	D IY
D-D-D-DON'T	D IY D IY D IY D OW N T
D-DID	D IY D IH D
DA.	D AA
DACHSHUND?	D AA K S HH UH N T
DAD	D AE D
DAD!	D AE D
DAD'S	D AE D Z
DAD,	D AE D
DAD.	D AE D
DAD?	D AE D
DADA.	D AA D AA
DADA?	D AA D AA
DADDY,	D AE D IY
DADDY.	D AE D IY
DAILY	D EY L IY
DALE!	D EY L
DAM.	D AE M
DAMN	D AE M
DAMN!	D AE M
DAMN.	D AE M
DANCE	D AE N S
DANCE.	D AE N S
DANCE?	D AE N S
DANCING,	D AE N S IH NG
DANCING.	D AE N S IH NG
DANCING?	D AE N S IH NG
DANGER.	D EY N JH ER
DANGEROUS.	D EY N JH ER AH S
DANGERS	D EY N JH ER Z
DARK	D AA R K
DARKENING,	D AA R K AH N IH NG
DATE	D EY T
DATE!	D EY T
DAUGHTER	D AO T ER
DAUGHTER,	D AO T ER
DAUGHTER.	D AO T ER
DAVID	D EY V IH D
DAVIN!	D AE V AH N
DAVIN'S	D AE V IH N Z
DAVIN.	D AE V AH N
DAVIN?	D AE V AH N
DAWG.	D AO G
DAY	D EY
DAY,	D EY
DAY.	D EY
DAY?	D EY
DAYS	D EY Z
DAYS,	D EY Z
DAYS.	D EY Z
DEAD	D EH D
DEAD!	D EH D
DEAD.	D EH D
DEAF	D EH F
DEAL	D IY L
DEAL.	D IY L
DEALING	D IY L IH NG
DEALS	D IY L Z
DEAR.	D IH ER
DEATH	D EH TH
DEATH!	D EH TH
DEATH.	D EH TH
DEBASE	D AH B EY S
DECAPITATE	D IY K AE P AH T EY T
DECAYING.	D IH K EY IH NG
DECIMATE	D EH S AH M EY T
DECISION.	D IH S IH ZH AH N
DECLARATION	D EH K L ER EY SH AH N
DECLINE.	D IH K L AY N
DECONSTRUCTING	D IY K AH N S T R AH K T IH NG
DEDUCTIBLE.	D IY D AH K T AH B AH L
DEEJAY,	D IY EH JH EY IY
DEEP	D IY P
DEEP,	D IY P
DEEP-CORE	D IY P K AO R
DEEZY	D IY IY Z IY
DEFENSIVE,	D IH F EH N S IH V
DEFENSIVE.	D IH F EH N S IH V
DEFIBULIZER,	D AH F IH B Y AH L AY Z AH R
DEFIBULIZER?	D AH F IH B Y AH L AY Z AH R
DEFIES	D IH F AY Z
DEFINITELY	D EH F AH N AH T L IY
DEFINITION	D EH F AH N IH SH AH N
DEFORMED	D IH F AO R M D
DEFRACULATE?	D EH F R AH S AH L EY T
DEFRACULATOR.	D EH F R AH S AH L EY T AH R
DELAWARE.	D AH L AO AH R
DELAYS.	D IH L EY Z
DELICIOUS.	D IH L IH SH AH S
DELIGHT	D IH L AY T
DELIVER	D IH L IH V ER
DELUXE.	D IH L UH K S
DEMON?	D IY M AH N
DEMONIC	D IH M AA N IH K
DEMONS	D IY M AH N Z
DEMONS.	D IY M AH N Z
DENIED	D IH N AY D
DENNY	D EH N IY
DENT	D EH N T
DEPARTMENT?	D IY P AA R T M AH N T
DEPEND	D IH P EH N D
DEPENDING	D IH P EH N D IH NG
DEPP.	D EH P
DERBY.	D ER B IY
DERIVATIVE,	D IH R IH V AH T IH V
DESERVE	D IH Z ER V
DESERVED	D IH Z ER V D
DESETER	D IY S EH T ER
DESIGN	D IH Z AY N
DESIGNED	D IH Z AY N D
DESIRE,	D IH Z AY ER
DESIRE?	D IH Z AY ER
DESK	D EH S K
DESK.	D EH S K
DESTROY	D IH S T R OY
DESTROYED	D IH S T R OY D
DESTROYED.	D IH S T R OY D
DESTRUCTION.	D IH S T R AH K SH AH N
DESTRUCTIVE	D IH S T R AH K T IH V
DETAIL	D IH T EY L
DETAIL(2)	D IY T EY L
DETAIL,	D IH T EY L
DETAILS.	D IH T EY L Z
DETECT	D IH T EH K T
DETECTIVE,	D IH T EH K T IH V
DETECTIVE.	D IH T EH K T IH V
DETECTS	D IH T EH K T S
DEVELOP	D IH V EH L AH P
DEVELOPED	D IH V EH L AH P T
DEVICE	D IH V AY S
DEVICE,	D IH V AY S
DEVICE.	D IH V AY S
DEVIL	D EH V AH L
DEVIL,	D EH V AH L
DEVIL.	D EH V AH L
DEVIL?	D EH V AH L
DIABETES,	D AY AH B IY T IY Z
DIABOLIC	D AY AH B AA L IH K
DIABOLICAL	D AY AH B AA L IH K AH L
DIAMOND	D AY M AH N D
DICAPRIO'S	D IH K AE P R IY OW Z
DICK	D IH K
DICK.	D IH K
DID	D IH D
DID,	D IH D
DID.	D IH D
DIDN'T	D IH D AH N T
DIDN'T(2)	D IH D N T
DIDN'T(3)	D IH D AH N
DIDN'T(4)	D IH N T
DIDN'T,	D IH D AH N T
DIDN'T.	D IH D AH N T
DIE	D AY
DIE!	D AY
DIE,	D AY
DIE.	D AY
DIED	D AY D
DIED,	D AY D
DIFFERENCE	D IH F ER AH N S
DIFFERENCE(2)	D IH F R AH N S
DIFFERENCES.	D IH F ER AH N S IH Z
DIFFERENT	D IH F ER AH N T
DIFFERENT(2)	D IH F R AH N T
DIFFERENT!	D IH F ER AH N T
DIFFERENT,	D IH F ER AH N T
DIFFERENT.	D IH F ER AH N T
DIFFERENT?	D IH F ER AH N T
DIFFERENTLY	D IH F R AH N T L IY
DIFFERENTLY(2)	D IH F ER EH N T L IY
DIGESTIVE	D AY JH EH S T IH V
DIGESTS	D AY JH EH S T S
DIGGING	D IH G IH NG
DIMENSION	D IH M EH N SH AH N
DIMENSION'S	D IH M EH N SH AH N Z
DIMENSION.	D AH M EH N CH AH N
DIMENSIONS	D IH M EH N SH AH N Z
DIMENSIONS,	D AH M EH N CH AH N Z
DIMENSIONS.	D AH M EH N CH AH N Z
DIMPLES	D IH M P AH L Z
DING-A-LING!	D IH NG EY L IH NG
DING-DONG!	D IH NG D AO NG
DINGDONGS	D IH N G D AH NG Z
DINNER.	D IH N ER
DINOSAUR.	D AY N AH S AO R
DIRECTED	D ER EH K T AH D
DIRECTED(2)	D ER EH K T IH D
DIRECTED(3)	D AY R EH K T IH D
DIRECTED(4)	D IH R EH K T IH D
DIRECTION.	D AH R EH K SH AH N
DIS	D IH S
DISABILITY	D IH S AH B IH L IH T IY
DISABILITY(2)	D IH S AH B IH L IH T IY Z
DISAGREE	D IH S AH G R IY
DISAGREE.	D IH S AH G R IY
DISAGREE?	D IH S AH G R IY
DISAPPEAR	D IH S AH P IH R
DISAPPEAR(2)	D IH S AH P IY R
DISAPPEARING	D IH S AH P IH R IH NG
DISAPPEARING(2)	D IH S AH P IY R IH NG
DISAPPOINTED	D IH S AH P OY N T IH D
DISAPPOINTED(2)	D IH S AH P OY N IH D
DISARMING.	D IH S AA R M IH NG
DISASTER	D IH Z AE S T ER
DISCLOSURE,	D IH S K L OW ZH ER
DISCOLORATION	D IH S K AH L ER EY SH AH N
DISCOLORED	D IH S K AH L ER D
DISCOVER	D IH S K AH V ER
DISCOVERED	D IH S K AH V ER D
DISCUSSED	D IH S K AH S T
DISEASE.	D IH Z IY Z
DISEASES.	D IH Z IY Z IH Z
DISEASES?	D IH Z IY Z IH Z
DISGUSTING!	D IH S G AH S T IH NG
DISHES?	D IH SH IH Z
DISHWASHER'S	D IH SH W AA SH ER Z
DISMISS.	D IH S M IH S
DISPARAGING	D IH S P EH R IH JH IH NG
DISPENSE	D IH S P EH N S
DISPLAY	D IH S P L EY
DISRESPECT,	D IH S R IH S P EH K T
DISRUPTED	D IH S R AH P T IH D
DISS.	D IH S
DISSOLVING	D IH Z AO L V IH NG
DISTRACTION	D IH S T R AE K SH AH N
DISTRESS	D IH S T R EH S
DISTRICT	D IH S T R IH K T
DIVORCE.	D AH V OW R S
DIVVY	D IH V IY
DNA'S	D IY EH N EY Z
DNA.	D N AA
DO	D UW
DO!	D UW
DO,	D UW
DO-O-O-O-RS!	D UW OW OW OW AA R EH S
DO.	D UW
DO?	D UW
DOC,	D AA K
DOC.	D AA K
DOCTOR!	D AA K T ER
DOCTOR'S	D AA K T ER Z
DOCTOR.	D AA K T ER
DODGED	D AA JH D
DOES	D AH Z
DOES(2)	D IH Z
DOESN'T	D AH Z AH N T
DOESN'T(2)	D AH Z AH N
DOG	D AO G
DOG!	D AO G
DOG'S	D AO G Z
DOG.	D AO G
DOGS	D AA G Z
DOGS(2)	D AO G Z
DOGS.	D AO G Z
DOIN'?	D OY N
DOING	D UW IH NG
DOING,	D OW IH NG
DOING?	D OW IH NG
DOING?!	D OW IH NG
DOLL	D AA L
DOLL'S	D AA L Z
DOLLAR	D AA L ER
DOLLAR(2)	D AO L ER
DOLLARS	D AA L ER Z
DOLLARS(2)	D AO L ER Z
DOLLARS.	D AA L ER Z
DOMINATED	D AA M AH N EY T AH D
DOMINATION	D AA M AH N EY SH AH N
DOMINATION!	D AA M AH N EY SH AH N
DOMINATION.	D AA M AH N EY SH AH N
DON'T	D OW N T
DON'T(2)	D OW N
DON'T.	D OW N T
DONE	D AH N
DONE!	D AH N
DONE,	D AH N
DONE.	D AH N
DONE?!	D AH N
DOOMED.	D UW M D
DOOR,	D OW R
DOOR.	D OW R
DOORS	D AO R Z
DOORS!	D OW R Z
DOORS.	D OW R Z
DOR	D AO R
DORMANT.	D AO R M AH N T
DOT	D AA T
DOT,	D AA T
DOT-COM	D AA T K AA M
DOUBTING	D AW T IH NG
DOWN	D AW N
DOWN!	D AW N
DOWN,	D AW N
DOWN.	D AW N
DOWN?	D AW N
DOY,	D OW IY
DOZEN	D AH Z AH N
DR.	D R AY V
DR.(2)	D AA K T ER
DRAG	D R AE G
DRAGGED	D R AE G D
DRAGGING	D R AE G IH NG
DRAGON.	D R AE G AH N
DRAWING	D R AO IH NG
DREAM	D R IY M
DREAM,	D R IY M
DREAM.	D R IY M
DREAMER.	D R IY M ER
DREAMING	D R IY M IH NG
DREAMS	D R IY M Z
DREAMS!	D R IY M Z
DREAMS,	D R IY M Z
DREAMS.	D R IY M Z
DRESSED	D R EH S T
DRILLING?	D R IH L IH NG
DRINK.	D R IH NG K
DRINKING	D R IH NG K IH NG
DRINKING,	D R IH NG K IH NG
DRIVE	D R AY V
DRIVE!	D R AY V
DROP	D R AA P
DROP(2)	D R AO P
DROPPED	D R AA P T
DROPPED.	D R AA P T
DROPPIN'	D R AA P AH N
DROPS	D R AA P S
DRUGSTORE.	D R AH G S T OW R
DRUM	D R AH M
DRUMMER	D R AH M ER
DRUMS	D R AH M Z
DUB	D AH B
DUBS!	D AH B Z
DUCKS!	D AH K S
DUDE,	D Y UW D
DUE	D UW
DUE(2)	D Y UW
DUE?	D UW
DUH	D AH
DUH.	D UW
DUM-DUM.	D AH M D AH M
DUMB	D AH M
DUMB,	D AH M
DUMB.	D AH M
DUMBER.	D AH M ER
DUMMIES	D AH M IY Z
DUMP	D AH M P
DUMPED	D AH M P T
DURING	D UH R IH NG
DURING(2)	D Y UH R IH NG
DURING(3)	D ER IH NG
DWARF.	D W AO R F
DYING!	D AY IH NG
DYING.	D AY IH NG
DYNAMITE.	D AY N AH M AY T
E'S.	EH Z
E,	
E-NOMENON,	IY N AA M AH N AH N
E.	IY
EACH	IY CH
EAGER	IY G ER
EAR,	IH ER
EARLIER	ER L IY ER
EARLIER!	ER L IY ER
EARLIER.	ER L IY ER
EARLIER?	ER L IY ER
EARLY	ER L IY
EARLY.	ER L IY
EARS!	IH ER Z
EARTH	ER TH
EARTH,	ER TH
EARTH.	ER TH
EARTH?	ER TH
EASIER.	IY Z IY ER
EAST	IY S T
EASTERN	IY S T ER N
EASY	IY Z IY
EASY!	IY Z IY
EASY,	IY Z IY
EASY.	IY Z IY
EAT	IY T
EATING	IY T IH NG
ECCENTRIC	EH K S EH N T R IH K
EDGE.	EH JH
EDUCATIONAL	EH JH AH K EY SH AH N AH L
EDUCATIONAL(2)	EH JH Y UW K EY SH AH N AH L
EERILY	IH R AH L IY
EFFECT	IH F EH K T
EFFECT(2)	IY F EH K T
EFFECT(3)	AH F EH K T
EFFECTS,	IH F EH K T S
EFFECTS.	IH F EH K T S
EFFICIENT	IH F IH SH AH N T
EFFORT,	EH F ER T
EFFORT?	EH F ER T
EFFORTS	EH F ER T S
EGGNOG,	EH G N AH G
EGGNOG?	EH G N AH G
EGGS.	EH G Z
EH,	EY
EH.	EY
EIGHT	EY T
EIGHT-PLANET	EY T P L AE N AH T
EIGHTH	EY T TH
EIGHTH(2)	EY TH
EIGHTIES	EY T IY Z
EIN-DOUCHE.	AY N D AW CH
EITHER	IY DH ER
EITHER(2)	AY DH ER
EITHER,	IY DH ER
EITHER.	IY DH ER
ELABORATE	IH L AE B R AH T
ELABORATE(2)	IH L AE B ER EY T
ELECTRONIC	IH L EH K T R AA N IH K
ELECTRONICS.	IH L EH K T R AA N IH K S
ELECTRONS	IH L EH K T R AA N Z
ELEVEN	IH L EH V AH N
ELEVEN(2)	IY L EH V AH N
ELSE	EH L S
ELSE'S	EH L S IH Z
ELSE'S.	EH L S IH Z
ELSE.	EH L S
EM	EH M
EM,	EH M
EM.	EH M
EMBARRASSING.	IH M B AE R AH S IH NG
EMERGENCY	IH M ER JH AH N S IY
EMERGENCY(2)	IY M ER JH AH N S IY
EMERGENCY.	IH M ER JH AH N S IY
EMPEROR	EH M P ER ER
EMPLOYEE	EH M P L OY IY
EMPLOYEE(2)	IH M P L OY IY
EMPTY	EH M P T IY
EMPTY(2)	EH M T IY
ENCHILADAS.	IH N CH IH L AH D AH Z
END	EH N D
END.	EH N D
ENDED	EH N D AH D
ENDED(2)	EH N D IH D
ENDGAME?	EH N D G EY M
ENDING.	EH N D IH NG
ENDOW	EH N D AW
ENDS	EH N D Z
ENEMIES.	EH N AH M IY Z
ENEMY	EH N AH M IY
ENEMY,	EH N AH M IY
ENEMY?!	EH N AH M IY
ENERGY	EH N ER JH IY
ENGINE	EH N JH AH N
ENGINE(2)	IH N JH AH N
ENJOY	EH N JH OY
ENLARGE	EH N L AA R JH
ENOUGH	IH N AH F
ENOUGH(2)	IY N AH F
ENOUGH,	IH N AH F
ENOUGH.	IH N AH F
ENRICHING	EH N R IH CH IH NG
ENRICHING(2)	IH N R IH CH IH NG
ENTER	EH N T ER
ENTER(2)	EH N ER
ENTERED	EH N T ER D
ENTERED(2)	EH N ER D
ENTIRE	IH N T AY ER
ENTIRELY	IH N T AY ER L IY
ENTITLES	EH N T AY T AH L Z
ENTRAILS	EH N T R AH L Z
ENTRANCE	EH N T R AH N S
ENTRANCE.	EH N T R AH N S
EPIPHANIES	IH P IH F AH N IY Z
EPISODE	EH P IH S OW D
EQUAL	IY K W AH L
EQUALLY	IY K W AH L IY
EQUALS.	IY K W AH L Z
EQUALS?!	IY K W AH L Z
ERA	EH R AH
ERA(2)	IH R AH
ERECTION	IH R EH K SH AH N
ERIC	EH R IH K
ERNEST	ER N AH S T
ERNEST(2)	ER N IH S T
ERRAND	EH R AH N D
ESCAPE	IH S K EY P
ESPECIALLY	AH S P EH SH L IY
ESPECIALLY(2)	AH S P EH SH AH L IY
ET	EH T
ETERNITY	IH T ER N AH T IY
ETERNITY(2)	IY T ER N AH T IY
ETERNITY.	IH T ER N AH T IY
ETHAN!	EH TH AH N
ETHAN.	EH TH AH N
ETHAN?	EH TH AH N
EVACUATION	IH V AE K Y AH W EY SH AH N
EVACUATION(2)	IY V AE K Y AH W EY SH AH N
EVALUATION.	IH V AE L Y AH W EY SH AH N
EVE,	IY V
EVEN	IY V IH N
EVER	EH V ER
EVER.	EH V ER
EVERY	EH V ER IY
EVERY(2)	EH V R IY
EVERYBODY	EH V R IY B AA D IY
EVERYBODY'S	EH V R IY B AA D IY Z
EVERYBODY,	EH V R IH B AA D IY
EVERYBODY.	EH V R IH B AA D IY
EVERYONE	EH V R IY W AH N
EVERYONE'S	EH V R IY W AH N Z
EVERYTHING	EH V R IY TH IH NG
EVERYTHING'S	EH V R IY TH IH NG Z
EVERYTHING,	EH V R IY TH IH NG
EVERYTHING.	EH V R IY TH IH NG
EVERYTHING?	EH V R IY TH IH NG
EVIDENCE	EH V AH D AH N S
EVIL	IY V AH L
EVIL?	IY V AH L
EVOLUTIONARY	EH V AH L UW SH AH N EH R IY
EVOLUTIONARY(2)	IY V AH L UW SH AH N EH R IY
EVOLUTIONARY(3)	EH V OW L UW SH AH N EH R IY
EVOLUTIONARY(4)	IY V OW L UW SH AH N EH R IY
EVOLVED	IH V AA L V D
EVOLVED(2)	IY V AA L V D
EX	EH K S
EXACT	IH G Z AE K T
EXACTLY	IH G Z AE K T L IY
EXAMINE	IH G Z AE M IH N
EXCEPT	IH K S EH P T
EXCEPT,	IH K S EH P T
EXCITED	IH K S AY T AH D
EXCITED(2)	IH K S AY T IH D
EXCITED.	IH K S AY T IH D
EXCUSE	IH K S K Y UW S
EXCUSE(2)	IH K S K Y UW Z
EXECUTE.	EH K S AH K Y UW T
EXHALE	EH K S HH EY L
EXHIBITS	IH G Z IH B AH T S
EXHIBITS?	IH G Z IH B AH T S
EXIST	IH G Z IH S T
EXIST,	EH G Z IH S T
EXIST.	EH G Z IH S T
EXISTED	IH G Z IH S T AH D
EXISTED.	EH G Z IH S T IH D
EXISTENCE	EH G Z IH S T AH N S
EXISTENCE(2)	IH G Z IH S T AH N S
EXISTING.	EH G Z IH S T IH NG
EXISTS	IH G Z IH S T S
EXOTIC	IH G Z AA T IH K
EXPECT	IH K S P EH K T
EXPEND	IH K S P EH N D
EXPENSES	IH K S P EH N S IH Z
EXPERIENCE	IH K S P IH R IY AH N S
EXPERIENCES?	IH K S P IH R IY AH N S IH Z
EXPERIMENT.	IH K S P EH R AH M AH N T
EXPLODED!	IH K S P L OW D IH D
EXPLODED.	IH K S P L OW D IH D
EXPRESS	IH K S P R EH S
EXPRESS?	IH K S P R EH S
EXTRA	EH K S T R AH
EXTRACTED	EH K S T R AE K T IH D
EXTREME	IH K S T R IY M
EXTREME?	IH K S T R IY M
EYE	AY
EYES	AY Z
EYES,	AY Z
EYES.	AY Z
F	EH F
F.	EH F
FABLED	F EY B AH L D
FACE	F EY S
FACE!	F EY S
FACE.	F EY S
FACEBOOK.	F EY S B UH K
FACES	F EY S AH Z
FACES(2)	F EY S IH Z
FACT	F AE K T
FACT,	F AE K T
FADES,	F EY D Z
FAIL	F EY L
FAILED.	F EY L D
FAILING	F EY L IH NG
FAILURES	F EY L Y ER Z
FAIR	F EH R
FAIR.	F EH R
FAIR?	F EH R
FAIRS	F EH R Z
FAITH	F EY TH
FAKE	F EY K
FAKEDOORS	F EY K D OW R Z
FALL	F AO L
FALL(2)	F AA L
FALL,	F AO L
FALLS	F AO L Z
FALLS?	F AO L Z
FAMILIAR?	F AH M IH L Y ER
FAMILIES	F AE M AH L IY Z
FAMILIES(2)	F AE M L IY Z
FAMILIES.	F AE M AH L IY Z
FAMILY	F AE M AH L IY
FAMILY(2)	F AE M L IY
FAMILY!	F AE M AH L IY
FAMILY'S	F AE M AH L IY Z
FAMILY'S(2)	F AE M L IY Z
FAMILY,	F AE M AH L IY
FAMILY.	F AE M AH L IY
FAMILY?	F AE M AH L IY
FAMOUS	F EY M AH S
FAMOUS.	F EY M AH S
FANCY	F AE N S IY
FANTASTIC,	F AE N T AE S T IH K
FANTASY	F AE N T AH S IY
FANTASY(2)	F AE N AH S IY
FANTASY-TYPE	F AE N T AH S IY T AY P
FAR	F AA R
FAR,	F AA R
FAR.	F AA R
FARMERS	F AA R M ER Z
FART.	F AA R T
FARTS	F AA R T S
FASCINATING	F AE S AH N EY T IH NG
FASHIONABLE?	F AE SH AH N AH B AH L
FAST	F AE S T
FAST!	F AE S T
FAST,	F AE S T
FAST-FOOD	F AE S T F UW D
FAST.	F AE S T
FASTER	F AE S T ER
FASTER,	F AE S T ER
FATE	F EY T
FATHER	F AA DH ER
FATHER'S	F AA DH ER Z
FATHER,	F AA DH ER
FATHER-SON	F AA DH ER S AH N
FATHER.	F AA DH ER
FATHER?	F AA DH ER
FAULT	F AO L T
FAULT.	F AO L T
FAVOR	F EY V ER
FAVOR.	F EY V ER
FAVORITE	F EY V ER IH T
FAVORITE(2)	F EY V R AH T
FAVORS.	F EY V ER Z
FEAR	F IH R
FEAR.	F IH ER
FEARS	F IH R Z
FEE!	F IY
FEEL	F IY L
FEEL,	F IY L
FEEL.	F IY L
FEEL?!	F IY L
FEELING	F IY L IH NG
FEET	F IY T
FEET,	F IY T
FELL	F EH L
FELLA.	F EH L AH
FELLAS!	F EH L AH Z
FELT	F EH L T
FEMALE	F IY M EY L
FEMALES	F IY M EY L Z
FEMININE	F EH M AH N AH N
FEROCIOUS	F ER OW SH AH S
FERRARI'S	F ER AA R IY Z
FERTILIZED	F ER T AH L AY Z D
FETCH.	F EH CH
FEW	F Y UW
FI!	F IY
FIDO.	F IH D OW
FIELD,	F IY L D
FIELD.	F IY L D
FIENNES	F IY EH N EH S
FIENNES(2)	F Y EH N EH S
FIFTH	F IH F TH
FIFTH(2)	F IH TH
FIFTY	F IH F T IY
FIGHT	F AY T
FIGHTING	F AY T IH NG
FIGHTING,	F AY T IH NG
FIGURE	F IH G Y ER
FIGURE.	F IH G Y ER
FIGURED	F IH G Y ER D
FILE	F AY L
FILL	F IH L
FILLED	F IH L D
FILLING	F IH L IH NG
FILM	F IH L M
FINAL	F AY N AH L
FINALLY	F AY N AH L IY
FINALLY.	F AY N AH L IY
FINANCIAL	F AH N AE N SH AH L
FINANCIAL(2)	F IH N AE N SH AH L
FINANCIAL(3)	F AY N AE N SH AH L
FIND	F AY N D
FINE	F AY N
FINE!	F AY N
FINE,	F AY N
FINE-LOOKING	F AY N L UH K IH NG
FINE.	F AY N
FINGERPRINTS.	F IH NG G ER P R IH N T S
FINGERS	F IH NG G ER Z
FINISH	F IH N IH SH
FINISHED	F IH N IH SH T
FINISHED.	F IH N IH SH T
FIRE	F AY ER
FIRE(2)	F AY R
FIRE!	F AY ER
FIRED.	F AY ER D
FIRST	F ER S T
FIRST,	F ER S T
FIRST.	F ER S T
FISH	F IH SH
FISHING	F IH SH IH NG
FISHY	F IH SH IY
FIST	F IH S T
FIT	F IH T
FIT.	F IH T
FIVE	F AY V
FIVE.	F AY V
FIX	F IH K S
FIX.	F IH K S
FIXED,	F IH K S T
FIXED.	F IH K S T
FLAPS	F L AE P S
FLAPS.	F L AE P S
FLARPING	F L AA R P AH NG
FLATTERED	F L AE T ER D
FLATTERING	F L AE T ER IH NG
FLATTERING,	F L AE T ER IH NG
FLEESEEKS	F L IY S IY K S
FLIMFLAM	F L IH M F L AE M
FLIP	F L IH P
FLIPPY	F L IH P IY
FLOOR	F L AO R
FLOOR?	F L OW R
FLOW.	F L OW
FLU	F L UW
FLU,	F L UW
FLU-HATING	F L UW HH EY T IH NG
FLU.	F L UW
FLURLOW,	F L AH R L OW
FLY	F L AY
FLYING	F L AY IH NG
FO!	F OW
FO-HOME.	F OW HH OW M
FOCUS	F OW K AH S
FOCUS(2)	F OW K IH S
FOLLOW	F AA L OW
FOLLOW-THROUGH!	F AA L OW TH R UW
FOLLOW-THROUGH,	F AA L OW TH R UW
FOLLOW-THROUGH?!	F AA L OW TH R UW
FOLLOWS	F AA L OW Z
FONDLERS	F AA N D L AH R Z
FONDLERS.	F AA N D L AH R Z
FONDLERS?	F AA N D L AH R Z
FOOD	F UW D
FOOD.	F UW D
FOOD?	F UW D
FOOL	F UW L
FOOL.	F UW L
FOOT	F UH T
FOOTSTOOL,	F UH T S T UW L
FOR	F AO R
FOR(2)	F ER
FOR(3)	F R ER
FOR,	F AO R
FOR.	F AO R
FOR?	F AO R
FORBID	F ER B IH D
FORBID(2)	F AO B IH D
FORCED	F AO R S T
FOREFRONT	F AO R F R AH N T
FOREMOST,	F OW R M OW S T
FOREVER	F ER EH V ER
FOREVER.	F ER EH V ER
FORGET	F ER G EH T
FORGET(2)	F AO R G EH T
FORGIVE	F ER G IH V
FORGIVE(2)	F AO R G IH V
FORGIVEN,	F AO R G IH V AH N
FORMS	F AO R M Z
FORMULA	F AO R M Y AH L AH
FORWARD	F AO R W ER D
FORWARD,	F AO R W ER D
FOUGHT	F AO T
FOULED	F AW L D
FOUND	F AW N D
FOUNDATION	F AW N D EY SH AH N
FOUNTAINS	F AW N T AH N Z
FOUR	F AO R
FOUR.	F OW R
FOURTEEN	F AO R T IY N
FOURTEEN.	F OW R T IY N
FOURTY	F OW Y UH R T IY
FOURTY!	F OW Y UH R T IY
FOURTY.	F OW Y UH R T IY
FRACULATION!	F R AE K Y AH L EY SH AH N
FRANK	F R AE NG K
FRANK.	F R AE NG K
FRANK?	F R AE NG K
FRAUD.	F R AO D
FREAKING	F R IY K IH NG
FREE	F R IY
FREE!	F R IY
FREE,	F R IY
FREE-FI	F R IY F AY
FREE.	F R IY
FREELY.	F R IY L IY
FREEZER,	F R IY Z ER
FRESH	F R EH SH
FRIDAY	F R AY D IY
FRIDAY(2)	F R AY D EY
FRIEND	F R EH N D
FRIEND,	F R EH N D
FRIEND.	F R EH N D
FRIENDS	F R EH N D Z
FRIENDSHIP	F R EH N D SH IH P
FRIENDSHIP.	F R EH N D SH IH P
FROGS	F R AA G Z
FROM	F R AH M
FROM,	F R AH M
FROM?	F R AH M
FRONT	F R AH N T
FRONT.	F R AH N T
FROZE	F R OW Z
FROZEN	F R OW Z AH N
FROZEN,	F R OW Z AH N
FRUIT	F R UW T
FRUITS.	F R UW T S
FRUSTRATING	F R AH S T R EY T IH NG
FRY.	F R AY
FRYING	F R AY IH NG
FUCK	F AH K
FUCK.	F AH K
FUCKIN'	F AH K AH N
FUCKING	F AH K IH NG
FUCKS	F AH K S
FUEL	F Y UW AH L
FUEL(2)	F Y UW L
FULFILL	F UH L F IH L
FULFILL!	F UH L F IH L
FULFILLS	F UH L F IH L Z
FULL	F UH L
FULLY	F UH L IY
FUM!	F AH M
FUMBLING	F AH M B AH L IH NG
FUMBLING(2)	F AH M B L IH NG
FUN	F AH N
FUN'S	F AH N Z
FUN.	F AH N
FUNCTIONALITY	F AH NG K SH AH N AE L IH T IY
FUNDAMENTALS	F AH N D AH M EH N T AH L Z
FUNDAMENTALS(2)	F AH N D AH M EH N AH L Z
FUNDRAISER.	F AH N D R EY Z ER
FUNNY	F AH N IY
FUNNY.	F AH N IY
FUR	F ER
FUTURE	F Y UW CH ER
FUTURE!	F Y UW CH ER
G	JH IY
G-G-GIVE	JH IY JH IY G IH V
G-GET	JH IY G EH T
G-GIVE	JH IY G IH V
G-GUY	JH IY G AY
GADGETS	G AE JH AH T S
GADGETS.	G AE JH AH T S
GALAXY'S	G AE L AH K S IY Z
GALAXY,	G AE L AH K S IY
GALILEO	G AE L AH L IY OW
GALILEO(2)	G AE L AH L EY OW
GAME	G EY M
GAME!	G EY M
GAME,	G EY M
GAME-DAY	G EY M D EY
GAME.	G EY M
GAME?	G EY M
GAME?!	G EY M
GAMES	G EY M Z
GAMES!	G EY M Z
GAMES,	G EY M Z
GAP.	G AE P
GAR	G AA R
GARAGE.	G AH R AA ZH
GARBAGE,	G AA R B IH JH
GARBAGE.	G AA R B IH JH
GARBAGE?	G AA R B IH JH
GARFIELD,	G AA R F IY L D
GAS	G AE S
GAS.	G AE S
GAS?	G AE S
GATEWAY	G EY T W EY
GAVE	G EY V
GAY,	G EY
GAZORPAZORP	G AH Z AO R P AH Z AH R P
GAZORPAZORP'S	G AH Z AO R P AH Z AH R P S
GAZORPAZORP-FUCKIN'-	G AH Z AO R P AH Z AH R P F AH K IH N Z
GAZORPAZORP.	G AH Z AO R P AH Z AH R P
GAZORPAZORPFIELD,	G AH Z AO R P AE Z AH R P IY L D
GAZORPAZORPFIELD.	G AH Z AO R P AE Z AH R P IY L D
GAZORPIAN	G AH Z AO R P IY AH N
GAZORPIANS	G AH Z AO R P IY AH N Z
GEAR.	G IH ER
GEE,	JH IY
GEEZ!	JH IY Z
GEEZ,	JH IY Z
GEEZ.	JH IY Z
GENDER	JH EH N D ER
GENDER.	JH EH N D ER
GENDERS	JH EH N D ER Z
GENE	JH IY N
GENERATES	JH EH N ER EY T S
GENERATOR	JH EH N ER EY T ER
GENES.	JH IY N Z
GENETIC	JH AH N EH T IH K
GENETICALLY	JH AH N EH T IH K L IY
GENETICALLY.	JH AH N EH T IH K AH L IY
GENITALIA?!	JH EH N AH T EY L Y AH
GENIUS	JH IY N Y AH S
GENIUS.	JH IY N Y AH S
GENTLEMEN,	JH EH N T AH L M EH N
GENTLEMEN?	JH EH N T AH L M EH N
GERMANY	JH ER M AH N IY
GERP.	JH AH R P
GET	G EH T
GET(2)	G IH T
GET,	G EH T
GETCHA?	JH EH CH AH
GETS	G EH T S
GETS(2)	G IH T S
GETTING	G EH T IH NG
GETTING(2)	G IH T IH NG
GETTING?	G EH T IH NG
GHOST	G OW S T
GHOSTBUSTERS,	G OW S T B AH S T ER Z
GI-I-I-I-IT	JH IY AY AY AY IH T
GIANT	JH AY AH N T
GIANT'S	JH AY AH N T S
GIANT,	JH AY AH N T
GIANT.	JH AY AH N T
GIANTS.	JH AY AH N T S
GIFTED	G IH F T AH D
GIFTED(2)	G IH F T IH D
GIRL	G ER L
GIRL!	G ER L
GIRL.	G ER L
GIRLFRIEND.	G ER L F R EH N D
GIRLS	G ER L Z
GIRLS.	G ER L Z
GIRVONESK.	JH AH R V AH N AH S
GIVE	G IH V
GIVEN	G IH V AH N
GIVEN(2)	G IH V IH N
GIVES	G IH V Z
GIVING	G IH V IH NG
GIVING.	G IH V IH NG
GLAD	G L AE D
GLARP	G L AA R P
GLASS	G L AE S
GLEN,	G L EH N
GLENN'S	G L EH N Z
GLENN,	G L EH N
GLOBALLY-COMPLIANT	G L OW B AH L IY K AH M P L AY AH N T
GLOVES	G L AH V Z
GO	G OW
GO!	G OW
GO,	G OW
GO.	G OW
GO?	G OW
GOBBA	G AA B AH
GOBLINS	G AA B L IH N Z
GOD	G AA D
GOD!	G AA D
GOD'S	G AA D Z
GOD,	G AA D
GOD.	G AA D
GOD?	G AA D
GODS.	G AA D Z
GOES	G OW Z
GOES,	G OW Z
GOES.	G OW Z
GOGGLES	G AA G AH L Z
GOING	G OW IH NG
GOING(2)	G OW IH N
GOING.	G OW IH NG
GOING?	G OW IH NG
GOLDEN	G OW L D AH N
GOLDENFOLD	G OW L D AH N F OW L D
GOLDENFOLD'S	G OW L D AH N F OW L D Z
GOLDENFOLD,	G OW L D AH N F OW L D
GOLDENFOLD.	G OW L D AH N F OW L D
GOLF	G AA L F
GOLF(2)	G AO L F
GONE	G AO N
GONE,	G AO N
GONE?	G AO N
GONNA	G AA N AH
GONORRHEA	G AA N ER IY AH
GONORRHEA!	G AO N ER R IY AH
GOOD	G UH D
GOOD(2)	G IH D
GOOD,	G UH D
GOOD.	G UH D
GOODBYE.	G UW D AY
GOODBYE?	G UW D AY
GOODNESS,	G UH D N AH S
GOOFBALL.	G UW F B AO L
GOOGLE!	G OW OW G AH L
GOOGLED	G UW G AH L D
GOT	G AA T
GOT,	G AA T
GOT.	G AA T
GOT?	G AA T
GOTCHA!	G AA CH AH
GOTS	G AA T S
GOTTA	G AA T AH
GOTTEN	G AA T AH N
GOTTEN(2)	G AO T AH N
GOVERNMENT'S	G AH V ER N M AH N T S
GRAB	G R AE B
GRADE.	G R EY D
GRADES	G R EY D Z
GRADES,	G R EY D Z
GRANDFATHER'S	G R AE N D F AA DH ER Z
GRANDFATHER'S(2)	G R AE N F AA DH ER Z
GRANDFATHER?	G R AE N D F AA DH ER
GRANDPA	G R AE N D P AA
GRANDPA!	G R AE N D P AH
GRANDPA,	G R AE N D P AH
GRANDPA?	G R AE N D P AH
GRANDSON	G R AE N D S AH N
GRANDSON'S	G R AE N D S AH N Z
GRAPPLING	G R AE P L IH NG
GRAPPLING(2)	G R AE P AH L IH NG
GRAVE	G R EY V
GRAVE.	G R EY V
GRAVES	G R EY V Z
GREAT	G R EY T
GREAT!	G R EY T
GREAT,	G R EY T
GREAT.	G R EY T
GREATEST	G R EY T AH S T
GREECE.	G R IY S
GREED!	G R IY D
GROSS	G R OW S
GROSS!	G R OW S
GROSS.	G R OW S
GROUND	G R AW N D
GROUNDED!	G R AW N D IH D
GROUP	G R UW P
GROUPS	G R UW P S
GROW	G R OW
GROWING	G R OW IH NG
GROWTH	G R OW TH
GRUESOME	G R UW S AH M
GUESS	G EH S
GUEST,	G EH S T
GUILT	G IH L T
GUILTY	G IH L T IY
GUILTY.	G IH L T IY
GUITAR.	G AH T AA R
GULLIBLE	G AH L AH B AH L
GUN	G AH N
GUN'S	G AH N Z
GUN.	G AH N
GUNS.	G AH N Z
GUY	G AY
GUY!	G AY
GUY'S	G AY Z
GUY,	G AY
GUY.	G AY
GUYS	G AY Z
GUYS!	G AY Z
GUYS,	G AY Z
GUYS.	G AY Z
GUYS?	G AY Z
GWENDOLYN	G W EH N D AH L IH N
H-H-HOW	EY CH EY CH HH AW
H-HE	EY CH HH IY
H-HEY,	EY CH HH EY
H-HOW	EY CH HH AW
HA	HH AA
HA!	HH AA
HA,	HH AA
HA-HA!	HH AA HH AA
HACK.	HH AE K
HACK?	HH AE K
HAD	HH AE D
HADN'T	HH AE D AH N T
HADN'T(2)	HH AE D AH N
HAIR,	HH EH R
HAIRCUT?	HH EH R K AH T
HAIRS.	HH EH R Z
HAIRY.	HH EY R IY
HALF	HH AE F
HALF-GOD	HH AE F G AA D
HALFWAY	HH AE F W EY
HALTED	HH AO L T AH D
HALTED(2)	HH AO L T IH D
HALVES	HH AE V Z
HALZINGERS,	HH AE L Z IH N JH AH R Z
HAM	HH AE M
HAM.	HH AE M
HAMSTER	HH AE M S T ER
HAMSTERS	HH AE M S T ER Z
HAND	HH AE N D
HAND,	HH AE N D
HAND-SHAPED	HH AE N D SH EY P T
HAND?	HH AE N D
HANDFUL.	HH AE N D F UH L
HANDICAP	HH AE N D IY K AE P
HANDLE	HH AE N D AH L
HANDLEBAR	HH AE N D AH L B AA R
HANDLED	HH AE N D AH L D
HANDS	HH AE N D Z
HANDS(2)	HH AE N Z
HANDS!	HH AE N D Z
HANDS,	HH AE N D Z
HANDS.	HH AE N D Z
HANDS?	HH AE N D Z
HANDY	HH AE N D IY
HANG-UP.	HH AE NG AH P
HANG-UPS	HH AE NG AH P S
HANG-UPS.	HH AE NG AH P S
HANGING	HH AE NG IH NG
HANGING(2)	HH AE NG G IH NG
HAPHAZARDLY,	HH AE P HH AE Z ER D L IY
HAPPEN	HH AE P AH N
HAPPEN,	HH AE P AH N
HAPPEN.	HH AE P AH N
HAPPEN?	HH AE P AH N
HAPPENED	HH AE P AH N D
HAPPENED.	HH AE P AH N D
HAPPENING	HH AE P AH N IH NG
HAPPENING(2)	HH AE P N IH NG
HAPPENING.	HH AE P AH N IH NG
HAPPENING?	HH AE P AH N IH NG
HAPPENS,	HH AE P AH N Z
HAPPINESS.	HH AE P IY N AH S
HAPPY	HH AE P IY
HAPPY.	HH AE P IY
HAPPY?	HH AE P IY
HARBOR.	HH AA R B ER
HARD	HH AA R D
HARD,	HH AA R D
HARD-CORE	HH AA R D K AO R
HARD.	HH AA R D
HARM!	HH AA R M
HARM.	HH AA R M
HARMLESS	HH AA R M L AH S
HAROLD!	HH AH R OW L D
HARRUMPH.	HH AE R AH M F
HAS	HH AE Z
HAS(2)	HH AH Z
HASN'T	HH AE Z AH N T
HASSLE.	HH AE S AH L
HASTE	HH EY S T
HAT	HH AE T
HATE	HH EY T
HATE,	HH EY T
HATED	HH EY T AH D
HATED(2)	HH EY T IH D
HAUNTED	HH AO N T AH D
HAUNTED(2)	HH AO N T IH D
HAVE	HH AE V
HAVEN'T	HH AE V AH N T
HAVEN'T(2)	HH AE V AH N
HAVIN'	HH AE V IH N
HAVING	HH AE V IH NG
HE	HH IY
HE'D	HH IY D
HE'LL	HH IY L
HE'S	HH IY Z
HE?	HH IY
HEAD	HH EH D
HEAD,	HH EH D
HEAD.	HH EH D
HEADLINES	HH EH D L AY N Z
HEADS	HH EH D Z
HEADS!	HH EH D Z
HEALED	HH IY L D
HEALTH	HH EH L TH
HEAR	HH IY R
HEARD	HH ER D
HEARD.	HH ER D
HEART	HH AA R T
HEART,	HH AA R T
HEARTBREAK,	HH AA R T B R EY K
HEAT	HH IY T
HEAVEN	HH EH V AH N
HEAVYWEIGHT	HH EH V IY W EY T
HECK,	HH EH K
HECK?	HH EH K
HECKLING	HH EH K L IH NG
HEDGES,	HH EH JH IH Z
HELL	HH EH L
HELL'S	HH EH L Z
HELL,	HH EH L
HELL?	HH EH L
HELL?!	HH EH L
HELLO!	HH AH L OW
HELLO,	HH AH L OW
HELLO.	HH AH L OW
HELLO?	HH AH L OW
HELP	HH EH L P
HELP!	HH EH L P
HELP,	HH EH L P
HELP.	HH EH L P
HELPED	HH EH L P T
HELPER.	HH EH L P ER
HELPING	HH EH L P IH NG
HEMINGWAY.	HH EH M IH NG W EY
HEN-PECKING	HH EH N P EH K IH NG
HEPATITIS	HH EH P AH T AY T AH S
HER	HH ER
HER!	HH ER
HER.	HH ER
HER?	HH ER
HERBRAND-NEW.	HH AH R B R AH N D N UW
HERE	HH IY R
HERE!	HH IH ER
HERE'S	HH IH R Z
HERE'SHUMAN	HH IH ER Z HH Y UW M AH N
HERE,	HH IH ER
HERE.	HH IH ER
HERE?	HH IH ER
HEREBY	HH IH R B AY
HERO	HH IH R OW
HERO(2)	HH IY R OW
HERO,	HH IY R OW
HEROES	HH IH R OW Z
HEROES(2)	HH IY R OW Z
HEROES!	HH IY R OW Z
HEROES,	HH IY R OW Z
HESITATE,	HH EH Z AH T EY T
HEY	HH EY
HEY!	HH EY
HEY,	HH EY
HEY-OH!	HH EY OW
HEY.	HH EY
HI!	HH AY
HI,	HH AY
HI.	HH AY
HID	HH IH D
HIDDEN	HH IH D AH N
HIDE!	HH AY D
HIDE,	HH AY D
HIDING.	HH AY D IH NG
HIGH	HH AY
HIGH-CONCEPT	HH AY K AA N S EH P T
HIGH-MAINTENANCE	HH AY M EY N T AH N AH N S
HIGH-ROAD	HH AY R OW D
HIGH-SCHOOL	HH AY S K UW L
HIGHER	HH AY ER
HIGHEST	HH AY AH S T
HIGHNESS,	HH AY N AH S
HIM	HH IH M
HIM(2)	IH M
HIM!	HH IH M
HIM,	HH IH M
HIM.	HH IH M
HIM?	HH IH M
HIMSELF	HH IH M S EH L F
HIMSELF.	HH IH M S EH L F
HIRING	HH AY R IH NG
HIS	HH IH Z
HISPANIC,	HH AY Z P AE N IH K
HISTORY	HH IH S T ER IY
HISTORY(2)	HH IH S T R IY
HISTORY.	HH IH S T AH R IY
HIT	HH IH T
HITLER	HH IH T L ER
HITLER,	HH AY T L AH R
HITS	HH IH T S
HITS.	HH IH T S
HITTING	HH IH T IH NG
HMM,	EY CH EH M EH M
HMM.	EY CH EH M EH M
HMM?	EY CH EH M EH M
HO,	HH OW
HOBBY.	HH AA B IY
HOLD	HH OW L D
HOLD.	HH OW L D
HOLDING	HH OW L D IH NG
HOLDINGONE.	HH OW L D IH N G AO N
HOLE	HH OW L
HOLE,	HH OW L
HOLE.	HH OW L
HOLE?	HH OW L
HOLES	HH OW L Z
HOLIDAY	HH AA L AH D EY
HOLIDAY(2)	HH AA L IH D EY
HOLIDAY!	HH AA L AH D EY
HOLIDAY,	HH AA L AH D EY
HOLLYWOOD	HH AA L IY W UH D
HOLY	HH OW L IY
HOME	HH OW M
HOME!	HH OW M
HOME,	HH OW M
HOME.	HH OW M
HOME?	HH OW M
HOMELESS	HH OW M L AH S
HOMES?	HH OW M Z
HOMEWORK	HH OW M W ER K
HOMEWORK?	HH OW M W ER K
HONEST	AA N AH S T
HONESTLY.	AA N AH S T L IY
HONESTY	AA N AH S T IY
HONEY,	HH AH N IY
HONEY.	HH AH N IY
HONK	HH AO NG K
HONOR	AA N ER
HONOR,	AA N ER
HOOKED.	HH UH K T
HOPE	HH OW P
HOPE,	HH OW P
HOPING	HH OW P IH NG
HORN,	HH AO R N
HORRIBLE	HH AO R AH B AH L
HORRIBLE?	HH AO R AH B AH L
HORROR	HH AO R ER
HORSE	HH AO R S
HORSE.	HH AO R S
HORSEPLAY	HH AO R S P L EY
HORSEPOWER	HH AO R S P AW ER
HORSES,	HH AO R S IH Z
HORSES.	HH AO R S IH Z
HOSPITAL	HH AA S P IH T AH L
HOSPITAL.	HH AA S P IH T AH L
HOT	HH AA T
HOT,	HH AA T
HOTEL	HH OW T EH L
HOUR	AW ER
HOUR(2)	AW R
HOUR.	AW ER
HOURS	AW ER Z
HOURS(2)	AW R Z
HOURS!	AW ER Z
HOURS,	AW ER Z
HOURS.	AW ER Z
HOURS?	AW ER Z
HOUSE	HH AW S
HOUSE!	HH AW S
HOUSE,	HH AW S
HOUSE.	HH AW S
HOUSE?	HH AW S
HOUSE?!	HH AW S
HOW	HH AW
HOW'S	HH AW Z
HOW?	HH AW
HUGE	HH Y UW JH
HUGE(2)	Y UW JH
HUH	HH AH
HUH,	HH UW
HUH.	HH UW
HUH?	HH UW
HUH?!	HH UW
HUMAN	HH Y UW M AH N
HUMAN(2)	Y UW M AH N
HUMAN!	HH Y UW M AH N
HUMAN'S	HH Y UW M AH N Z
HUMAN-RIGHTS	HH Y UW M AH N R AY T S
HUMAN.	HH Y UW M AH N
HUMAN?	HH Y UW M AH N
HUMANITY	HH Y UW M AE N IH T IY
HUMANITY(2)	Y UW M AE N IH T IY
HUMANITY'S	HH Y UW M AE N IH T IY Z
HUMANITY'S(2)	Y UW M AE N IH T IY Z
HUMANITY.	HH Y UW M AE N AH T IY
HUMANITY?	HH Y UW M AE N AH T IY
HUMANS	HH Y UW M AH N Z
HUMANS(2)	Y UW M AH N Z
HUMBLE	HH AH M B AH L
HUMBLED.	HH AH M B AH L D
HUMBLING	HH AH M B AH L IH NG
HUMBLING(2)	HH AH M B L IH NG
HUNDRED	HH AH N D R AH D
HUNDRED(2)	HH AH N D R IH D
HUNDRED(3)	HH AH N ER D
HUNDRED(4)	HH AH N D ER D
HUNGRY	HH AH NG G R IY
HUNGRY.	HH AH N G R IY
HUNGRYFORAPPLES?!	HH AH N G R IY F AO R AE P AH L Z
HURRY	HH ER IY
HURRY!	HH ER IY
HURRY.	HH ER IY
HURT	HH ER T
HURT.	HH ER T
HURTS!	HH ER T S
HURTS,	HH ER T S
HUSBAND	HH AH Z B AH N D
HYDRATED.	HH AY D R EY T IH D
I	AY
I'D	AY D
I'LL	AY L
I'M	AY M
I'M(2)	AH M
I'M-A	AY M EY
I'VE	AY V
I,	AY
I-I	AY AY
I-I'M	AY AY M
I-I-I	AY AY AY
I-I-I'M	AY AY AY M
I-I-I-I	AY AY AY AY
I-I-I-I-I	AY AY AY AY AY
I-I-I-IF	AY AY AY IH F
I-I-I-IT'LL	AY AY AY IH T AH L
I-I-I-LOOK	AY AY AY L UH K
I-IF	AY IH F
I-IS	AY IH Z
I-IT	AY IH T
I-IT'S	AY IH T S
I-LITTLE	AY L IH T AH L
I-TOLD-YOU	AY T OW L D Y UW
I?	AY
I?!	AY
IAMFINALLY	AY AE M F AH N AE L IY
ICE	AY S
IDEA	AY D IY AH
IDEA,	AY D IY AH
IDEA.	AY D IY AH
IDEA?	AY D IY AH
IDENTICAL.	AY D EH N T IH K AH L
IDIOT	IH D IY AH T
IDIOT!	IH D IY AH T
IDIOT,	IH D IY AH T
IDIOT.	IH D IY AH T
IDIOT?	IH D IY AH T
IDIOTS	IH D IY AH T S
IDIOTS!	IH D IY AH T S
IDIOTS.	IH D IY AH T S
IF	IH F
IGNORE	IH G N AO R
II.	IY
ILL	IH L
ILL-MANNERED.	IH L M AE N ER D
IMAGINARIAN.	AH M AE JH AH N EH R IY AH N
IMAGINE	IH M AE JH AH N
IMPORTANT	IH M P AO R T AH N T
IMPORTANT,	IH M P OW R T AH N T
IMPORTANT.	IH M P OW R T AH N T
IMPORTANTLY,	IH M P OW R T AH N T L IY
IMPOSE	IH M P OW Z
IMPOSSIBILITY.	IH M P AA S AH B IH L AH T IY
IMPOSSIBLE,	IH M P AA S AH B AH L
IMPOTENT!	IH M P AH T AH N T
IMPRESS	IH M P R EH S
IMPRESSION	IH M P R EH SH AH N
IMPROVISATIONAL	IH M P R AA V IH Z EY SH AH N AH L
IMPROVISE.	IH M P R AH V AY Z
IMPROVISOR.	IH M P R AH V AY Z ER
IMPULSES,	IH M P AH L S IH Z
IN	IH N
IN,	IH N
IN-INTO	IH N IH N T UW
IN.	IH N
IN.(2)	IH N CH
INAPPROPRIATE.	IH N AH P R OW P R IY AH T
INCEPT	IH N S EH P T
INCEPTING	IH N S EH P T IH NG
INCEPTING?	IH N S EH P T IH NG
INCEPTION	IH N S EH P SH AH N
INCEPTION,	IH N S EH P SH AH N
INCEPTION?	IH N S EH P SH AH N
INCEPTOR,	IH N S EH P T ER
INCEPTORS	IH N S EH P T ER Z
INCIDENT.	IH N S AH D AH N T
INCLUDED,	IH N K L UW D IH D
INCLUDING	IH N K L UW D IH NG
INCONTINENT,	IH N K AA N T AH N AH N T
INCREASINGLY	IH N K R IY S IH NG G L IY
INCREDIBLE.	IH N K R EH D AH B AH L
INCREDIBLY	IH N K R EH D AH B L IY
INCREMENT	IH N K R AH M AH N T
INCUBATION	IH NG K Y UW B EY SH AH N
INDIAN	IH N D IY AH N
INDIANS!	IH N D IY AH N Z
INDIVIDUAL.	IH N D AH V IH JH AH W AH L
INDIVIDUALS.	IH N D AH V IH JH AH W AH L Z
INEVITABLE!	IH N EH V AH T AH B AH L
INEVITABLE.	IH N EH V AH T AH B AH L
INEVITABLY,	IH N EH V AH T AH B L IY
INFECTED!	IH N F EH K T IH D
INFINITE	IH N F AH N AH T
INFINITY'S	IH N F IH N IH T IY Z
INFLUENCE	IH N F L UW AH N S
INFO	IH N F OW
INFORMATION	IH N F AO R M EY SH AH N
INGREDIENT	IH N G R IY D IY AH N T
INJURING	IH N JH ER IH NG
INNOCENCE,	IH N AH S AH N S
INNOCENT	IH N AH S AH N T
INSANE	IH N S EY N
INSANE!	IH N S EY N
INSANE.	IH N S EY N
INSECT	IH N S EH K T
INSECURE	IH N S AH K Y ER
INSECURE.	IH N S IH K Y UH R
INSECURITY.	IH N S IH K Y UH R AH T IY
INSIDE	IH N S AY D
INSIDE!	IH N S AY D
INSIDE,	IH N S AY D
INSIDE?	IH N S AY D
INSIDES	IH N S AY D Z
INSIDES.	IH N S AY D Z
INSTANCE	IH N S T AH N S
INSTANTLY	IH N S T AH N T L IY
INSTANTLY.	IH N S T AH N T L IY
INSTEAD	IH N S T EH D
INSTEAD,	IH N S T EH D
INSULIN,	IH N S AH L AH N
INSULTING	IH N S AH L T IH NG
INSURANCE	IH N SH UH R AH N S
INTELLIGENT	IH N T EH L AH JH AH N T
INTENSE	IH N T EH N S
INTENTIONALLY	IH N T EH N SH AH N AH L IY
INTER-GENERATIONAL	IH N T ER JH EH N ER EY SH AH N AH L
INTERDIMENSIONAL	IH N T ER D AH M EH N CH AH N AH L
INTERESTED	IH N T AH R EH S T IH D
INTERESTING	IH N T AH R EH S T IH NG
INTERESTING,	IH N T R AH S T IH NG
INTERESTING.	IH N T R AH S T IH NG
INTERNAL	IH N T ER N AH L
INTERNALLY	IH N T ER N AH L IY
INTERNET	IH N T ER N EH T
INTERRUPT	IH N T ER AH P T
INTERRUPTING!	IH N T AH R AH P T IH NG
INTERSTELLAR	IH N T ER S T EH L ER
INTERVENE.	IH N T ER V IY N
INTERVENING	IH N T ER V IY N IH NG
INTERVENING.	IH N T ER V IY N IH NG
INTESTINE	IH N T EH S T AH N
INTESTINE(2)	IH N T EH S T AY N
INTESTINE!	IH N T EH S T AH N
INTESTINES	IH N T EH S T AH N Z
INTIMIDATING.	IH N T AH M AH D EY T IH NG
INTO	IH N T UW
INTO(2)	IH N T AH
INTRODUCE	IH N T R AH D UW S
INTRODUCE(2)	IH N T R OW D UW S
INVASION	IH N V EY ZH AH N
INVENT	IH N V EH N T
INVENTED	IH N V EH N T AH D
INVENTED(2)	IH N V EH N T IH D
INVENTORY.	IH N V AH N T OW R IY
INVESTIGATE.	IH N V EH S T AH G AH T
INVITATION	IH N V IH T EY SH AH N
INVOLVES	IH N V AA L V Z
INVOLVING	IH N V AA L V IH NG
IONIC	AY AA N IH K
IPAD.	IH P AH D
IRRESISTIBLE	IH R IH Z IH S T AH B AH L
IRRESPONSIBLE	IH R AH S P AA N S AH B AH L
IRRESPONSIBLE,	IH R IH S P AA N S AH B AH L
IRRESPONSIBLE?!	IH R IH S P AA N S AH B AH L
IS	IH Z
IS!	IH Z
IS,	IH Z
IS.	IH Z
IS?	IH Z
ISN'T	IH Z AH N T
ISN'T(2)	IH Z AH N
ISN'T.	IH Z AH N T
ISSUE	IH SH UW
ISSUE.	IH SH UW
IT	IH T
IT!	IH T
IT'D	IH T AH D
IT'LL	IH T AH L
IT'LL(2)	IH T L
IT'S	IH T S
IT'S,	IH T S
IT'SIT'STOO	IH T S IH T S T UW
IT,	IH T
IT.	IH T
IT?	IH T
ITALY.	IH T AH L IY
ITEMS	AY T AH M Z
ITEMS?	AY T AH M Z
ITS	IH T S
ITSELF	IH T S EH L F
ITUNES-GIFT-CARD-AS-A-HOLIDAY-	AY T UW N Z G IH F T K AA R D AE Z EY HH AA L AH D EY
J	JH EY
J,	JH EY
J-J	JH EY JH EY
J-J-J	JH EY JH EY JH EY
J-JESSICA	JH EY JH EH S IH K AH
J-JUST	JH EY JH AH S T
JACKIE!	JH AE K IY
JACOB	JH EY K AH B
JACOB.	JH AE K AH B
JACOB?	JH AE K AH B
JACOBS	JH EY K AH B Z
JACOBS.	JH AE K AH B Z
JAMBA	JH AE M B AH
JAMIE	JH EY M IY
JAPANESE	JH AE P AH N IY Z
JAR.	JH AA R
JAR?	JH AA R
JE-JESSICA.	JH IY JH EH S AH K AH
JEALOUS	JH EH L AH S
JEALOUSY	JH EH L AH S IY
JELLY	JH EH L IY
JELLY.	JH EH L IY
JEOPARDY.	JH EH P ER D IY
JERK!	JH ER K
JERRY	JH EH R IY
JERRY!	JH EH R IY
JERRY'S	JH EH R IY Z
JERRY,	JH EH R IY
JERRY.	JH EH R IY
JERRY?	JH EH R IY
JERRY?!	JH EH R IY
JESSICA	JH EH S IH K AH
JESSICA!	JH EH S AH K AH
JESSICA'S	JH EH S IH K AH Z
JESSICA,	JH EH S AH K AH
JESSICA.	JH EH S AH K AH
JESSICA?	JH EH S AH K AH
JESUS	JH IY Z AH S
JESUS!	JH IY Z AH S
JESUS.	JH IY Z AH S
JEWS	JH UW Z
JIGGLE	JH IH G AH L
JOB	JH AA B
JOB(2)	JH OW B
JOB!	JH AA B
JOB,	JH AA B
JOB.	JH AA B
JOB?	JH AA B
JOHN,	JH AA N
JOHN.	JH AA N
JOHNNY	JH AA N IY
JOHNSON'S	JH AA N S AH N Z
JOHNSON,	JH AA N S AH N
JOHNSON.	JH AA N S AH N
JOIN	JH OY N
JOINED	JH OY N D
JOINING	JH OY N IH NG
JOKING	JH OW K IH NG
JOLLY	JH AA L IY
JONES,	JH OW N Z
JOURNEY	JH ER N IY
JOURNEY'S	JH ER N IY Z
JOYCE,	JH OY S
JOYCE.	JH OY S
JR.	JH EY AA R
JR.!	JH EY AA R
JR.'S	JH EY AA R S
JR.,	JH EY AA R
JR.?	JH EY AA R
JR.?!	JH EY AA R
JU	JH UW
JUDGE,	JH AH JH
JUDGE.	JH AH JH
JUDGED	JH AH JH D
JUDGING	JH AH JH IH NG
JUDGING.	JH AH JH IH NG
JUDGMENT	JH AH JH M AH N T
JUICE	JH UW S
JUICE,	JH UW S
JUICE.	JH UW S
JUICE?	JH UW S
JUICY	JH UW S IY
JULIUS	JH UW L Y AH S
JUMP	JH AH M P
JUPITER	JH UW P AH T ER
JUPITER(2)	JH UW P IH T ER
JURY	JH UH R IY
JUST	JH AH S T
JUST(2)	JH IH S T
JUST,	JH AH S T
JUSTASPLANNED.	JH AH S T AE S L AH N D
JUSTGET	JH AH S T G EH T
K,	K EY
KANE.	K EY N
KEEP	K IY P
KEEPING	K IY P IH NG
KEEPS	K IY P S
KENTUCKY?	K EH N T AH K IY
KEPT	K EH P T
KEPT(2)	K AE P T
KEVIN	K EH V IH N
KID	K IH D
KID,	K IH D
KID.	K IH D
KIDDING	K IH D IH NG
KIDDING.	K IH D IH NG
KIDDING?	K IH D IH NG
KIDNEYS	K IH D N IY Z
KIDS	K IH D Z
KIDS,	K IH D Z
KIDS.	K IH D Z
KILL	K IH L
KILL.	K IH L
KILLED	K IH L D
KILLED.	K IH L D
KILLER.	K IH L ER
KILLING	K IH L IH NG
KIND	K AY N D
KIND.	K AY N D
KIND?	K AY N D
KINDS	K AY N D Z
KINDS(2)	K AY N Z
KING	K IH NG
KINGDOM,	K IH NG D AH M
KINGDOM.	K IH NG D AH M
KISSING	K IH S IH NG
KITTIES	K IH T IY Z
KNEES.	N IY Z
KNEW	N UW
KNEW(2)	N Y UW
KNIFE	N AY F
KNIVES	N AY V Z
KNIVES.	N AY V Z
KNOCK	N AA K
KNOCK,	N AA K
KNOCK-OFF	N AA K AO F
KNOCK.	N AA K
KNOCKED	N AA K T
KNOT	N AA T
KNOW	N OW
KNOW,	N OW
KNOW.	N OW
KNOW?	N OW
KNOWLEDGE	N AA L AH JH
KNOWLEDGE(2)	N AA L IH JH
KNOWN	N OW N
KNOWS	N OW Z
KOALA	K OW AA L AH
KOREA,	K AO R IY AH
KOREA.	K AO R IY AH
KRISTEN	K R IH S T AH N
L	EH L
L-LET'S	EH L L EH T S
LAB,	L AE B
LACK	L AE K
LADDERS.	L AE D ER Z
LADIES	L EY D IY Z
LADIES,	L EY D IY Z
LADY	L EY D IY
LADY'S	L EY D IY Z
LADY.	L EY D IY
LAID?	L EY D
LAME!	L EY M
LAME.	L EY M
LAME?	L EY M
LAND	L AE N D
LAND.	L AE N D
LANDED	L AE N D AH D
LANDED(2)	L AE N D IH D
LANGUAGER.	L AE NG G W IH JH ER
LAPTOPS.	L AE P T AA P S
LARGE	L AA R JH
LASAGNA.	L AH S AE G N AH
LASERS.	L AA Z ER Z
LAST	L AE S T
LAST!	L AE S T
LATE	L EY T
LATE,	L EY T
LATE?	L EY T
LATER	L EY T ER
LATER,	L EY T ER
LATER.	L EY T ER
LATINO	L AA T IY N OW
LATINO(2)	L AH T IY N OW
LAUGH?	L AE F
LAUNCH	L AO N CH
LAUNDRY	L AO N D R IY
LAUNDRY.	L AO N D R IY
LAVA!	L AA V AH
LAW	L AO
LAW(2)	L AA
LAWS	L AO Z
LAY	L EY
LEAD	L EH D
LEAD(2)	L IY D
LEAD.	L IY D
LEADING	L IY D IH NG
LEAGUE.	L IY G
LEAK,	L IY K
LEARN	L ER N
LEARNED	L ER N D
LEARNED(2)	L ER N IH D
LEARNHOW	L AH R N HH OW
LEARNING	L ER N IH NG
LEASH.	L IY SH
LEAST	L IY S T
LEAVE	L IY V
LEAVE.	L IY V
LEAVES,	L IY V Z
LEAVING	L IY V IH NG
LEAVING.	L IY V IH NG
LEDGE.	L EH JH
LEFT	L EH F T
LEFT,	L EH F T
LEFT.	L EH F T
LEG	L EH G
LEGALLY	L IY G AH L IY
LEGS	L EH G Z
LEGS,	L EH G Z
LEGS.	L EH G Z
LEISURELY	L IY Z ER L IY
LENGTHS	L EH NG K TH S
LENGTHS(2)	L EH NG TH S
LEONARD,	L IY AH N AH R D
LEONARD.	L IY AH N AH R D
LEPRECHAUN?	L EH P R AH CH AH N
LESS	L EH S
LESSON	L EH S AH N
LESSON.	L EH S AH N
LET	L EH T
LET'S	L EH T S
LETS	L EH T S
LETTERMAN	L EH T ER M AH N
LETTERMAN?	L EH T ER M AE N
LETTING	L EH T IH NG
LEVER	L EH V ER
LEVER(2)	L IY V ER
LEVER,	L IY V ER
LEVER.	L IY V ER
LI	L IY
LIBERTIES!	L IH B ER T IY Z
LID	L IH D
LIE!	L AY
LIFE	L AY F
LIFE!	L AY F
LIFE'S	L AY F S
LIFE,	L AY F
LIFE.	L AY F
LIFE?	L AY F
LIFELESS	L AY F L AH S
LIGHT.	L AY T
LIGHTEN	L AY T AH N
LIGHTER.	L AY T ER
LIGHTHOUSE,	L AY T HH AW S
LIKE	L AY K
LIKE,	L AY K
LIKE?	L AY K
LIKEAN	L AY K AH N
LIKED	L AY K T
LIMIT?	L IH M AH T
LINE	L AY N
LINKING	L IH NG K IH NG
LION	L AY AH N
LION.	L AY AH N
LIONS.	L AY AH N Z
LIST	L IH S T
LISTEN	L IH S AH N
LISTEN,	L IH S AH N
LISTEN.	L IH S AH N
LISTENED	L IH S AH N D
LISTENING	L IH S AH N IH NG
LISTENING(2)	L IH S N IH NG
LITERATURE	L IH T ER AH CH ER
LITTLE	L IH T AH L
LITTLE,	L IH T AH L
LITTLE-PEOPLE	L IH T AH L P IY P AH L
LITTLE.	L IH T AH L
LITTLE?	L IH T AH L
LIVE	L AY V
LIVE(2)	L IH V
LIVE,	L IH V
LIVE.	L IH V
LIVER'S	L IH V ER Z
LIVER,	L IH V ER
LIVER.	L IH V ER
LIVES	L IH V Z
LIVES(2)	L AY V Z
LIVES,	L IH V Z
LIVES.	L IH V Z
LIVES?	L IH V Z
LIVING	L IH V IH NG
LIVING-ROOM	L IH V IH NG R UW M
LOAD.	L OW D
LOADS!	L OW D Z
LOADS.	L OW D Z
LOCATED	L OW K EY T AH D
LOCATED(2)	L OW K EY D
LOCKBOX	L AA K B AA K S
LOCKED	L AA K T
LOGIC	L AA JH IH K
LOGIC,	L AA JH IH K
LONELY	L OW N L IY
LONG	L AO NG
LONG,	L AO NG
LONG.	L AO NG
LONGER	L AO NG G ER
LOOK	L UH K
LOOK!	L UH K
LOOK,	L UH K
LOOK.	L UH K
LOOKED	L UH K T
LOOKIN'	L UH K IH N
LOOKING	L UH K IH NG
LOOKS	L UH K S
LOOKS.	L UH K S
LOOSER	L UW S ER
LOOSER.	L UW S ER
LOP	L AA P
LORD,	L AO R D
LORENZO	L ER EH N Z OW
LORENZO(2)	L AO EH N Z OW
LOS	L OW S
LOS(2)	L AO S
LOSE	L UW Z
LOSER,	L UW Z ER
LOSING	L UW Z IH NG
LOSSES.	L AO S IH Z
LOST	L AO S T
LOT	L AA T
LOT(2)	L AO T
LOT!	L AA T
LOT.	L AA T
LOT?	L AA T
LOUD	L AW D
LOUD,	L AW D
LOUD.	L AW D
LOVE	L AH V
LOVE.	L AH V
LOVER.	L AH V ER
LOVES	L AH V Z
LOVES?	L AH V Z
LOVING	L AH V IH NG
LOW.	L OW
LOW?	L OW
LOWER	L OW ER
LUBBA	L AH B AH
LUCIUS.	L UW S AY AH S
LUCK	L AH K
LUCK,	L AH K
LUCK.	L AH K
LUCKY	L AH K IY
LUMBERING	L AH M B ER IH NG
LUNCH,	L AH N CH
LUNCH.	L AH N CH
LUNCH?	L AH N CH
LUNGS	L AH NG Z
LUST!	L AH S T
LYING	L AY IH NG
M	EH M
M-M-MORTY?	EH M EH M M AO R T IY
M-MEETING	EH M M IY T IH NG
M-MORTY.	EH M M AO R T IY
M-MORTY?	EH M M AO R T IY
MA	M AA
MA'AM!	M AE M
MA'AM?	M AE M
MACHINE,	M AH SH IY N
MACHINE.	M AH SH IY N
MACHINE?	M AH SH IY N
MACHINES.	M AH SH IY N Z
MAD.	M AE D
MAD?!	M AE D
MADE	M EY D
MAGIC.	M AE JH IH K
MAGICAL	M AE JH IH K AH L
MAIN	M EY N
MAINTAIN	M EY N T EY N
MAINTENANCE.	M EY N T AH N AH N S
MAJORING	M EY JH ER IH NG
MAKE	M EY K
MAKE-OR-BREAK	M EY K AO R B R EY K
MAKE?	M EY K
MAKER,	M EY K ER
MAKES	M EY K S
MAKING	M EY K IH NG
MALE	M EY L
MALE,	M EY L
MALES	M EY L Z
MALLEABLE.	M AE L IY AH B AH L
MALOTES,	M AH L OW T S
MAMMAL'S	M AE M AH L Z
MAMUMANUMS-DAYS,	M AE M Y UW M AH N AH M Z D EY Z
MAN	M AE N
MAN!	M AE N
MAN'S	M AE N Z
MAN,	M AE N
MAN.	M AE N
MAN?	M AE N
MANAGER	M AE N AH JH ER
MANAGER(2)	M AE N IH JH ER
MANDATORY.	M AE N D AH T OW R IY
MANHANDLE	M AE N HH AE N D AH L
MANIPULATED	M AH N IH P Y AH L EY T IH D
MANNIES	M AE N IY Z
MANTISES	M AE N T AY Z AH Z
MANUALLY.	M AE N Y AH W AH L IY
MANY	M EH N IY
MANY,	M EH N IY
MAR-SHA,	M AA R SH AA
MARC	M AA R K
MARC?	M AA R K
MARKETING,	M AA R K AH T IH NG
MARKLEVITZ,	M AA R K L AH V AH T S
MARMADUKE.	M AA R M AH D Y UW K
MARRIAGE	M EH R IH JH
MARRIAGE,	M AE R IH JH
MARRIAGE.	M AE R IH JH
MARRIED!	M AE R IY D
MARRIED,	M AE R IY D
MARRIED.	M AE R IY D
MARRY	M EH R IY
MASTERPIECE	M AE S T ER P IY S
MASTURBATE.	M AE S T AH R B EY T
MATCHING	M AE CH IH NG
MATE	M EY T
MATES	M EY T S
MATH	M AE TH
MATH!	M AE TH
MATH,	M AE TH
MATH.	M AE TH
MATH?	M AE TH
MATTER	M AE T ER
MATTER,	M AE T ER
MATTER.	M AE T ER
MATTER?	M AE T ER
MATTERED	M AE T ER D
MATTRESS	M AE T R AH S
MAY	M EY
MAY-MAYBE	M EY M EY B IY
MAYBE	M EY B IY
MAYBE!	M EY B IY
MAYONNAISE	M EY AH N EY Z
MAYOR	M EY ER
MC	M IH K
MC(2)	EH M S IY
MCMAHAN	M AH K M EY HH AH N
ME	M IY
ME!	M IY
ME,	M IY
ME.	M IY
ME?	M IY
ME?!	M IY
MEALS	M IY L Z
MEAN	M IY N
MEAN,	M IY N
MEAN.	M IY N
MEAN?	M IY N
MEANING,	M IY N IH NG
MEANINGFUL	M IY N IH NG F AH L
MEANS	M IY N Z
MEANT	M EH N T
MEANT.	M EH N T
MEASURE	M EH ZH ER
MECHANICAL	M AH K AE N IH K AH L
MEDIA.	M IY D IY AH
MEDICAL	M EH D AH K AH L
MEDICAL(2)	M EH D IH K AH L
MEDICINE	M EH D AH S AH N
MEDIOCRE?	M IY D IY OW K ER
MEESEEKS	M IY S IY K S
MEESEEKS!	M IY S IY K S
MEESEEKS,	M IY S IY K S
MEESEEKS.	M IY S IY K S
MEESEEKS?	M IY S IY K S
MEET	M IY T
MEETING.	M IY T IH NG
MEGA	M EH G AH
MELISSA.	M AH L IH S AH
MEN	M EH N
MEN'S	M EH N Z
MEN.	M EH N
MENTALLY	M EH N T AH L IY
MENTALLY(2)	M EH N AH L IY
MENTION	M EH N SH AH N
MEOW.	M IY OW
MERELY	M IH R L IY
MERRY	M EH R IY
MERRY,	M EH R IY
MESS	M EH S
MESSAGE?	M EH S IH JH
MESSAGES	M EH S AH JH AH Z
MESSAGES(2)	M EH S IH JH IH Z
MESSED	M EH S T
METAL,	M EH T AH L
METEOR	M IY T IY ER
METEOR,	M IY T IY ER
METH	M EH TH
MEXICAN	M EH K S AH K AH N
MEXICO.	M EH K S AH K OW
MICHAEL	M AY K AH L
MICHAELS.	M AH CH IY L Z
MICROSCOPE	M AY K R AH S K OW P
MICROSCOPE,	M AY K R OW S K OW P
MICROSCOPIC	M AY K R AH S K AA P IH K
MICROWAVE?	M AY K R OW W EY V
MICROWAVES,	M AY K R OW W EY V Z
MIDDLE	M IH D AH L
MIDNIGHT	M IH D N AY T
MIGHT	M AY T
MILES.	M AY L Z
MILITARY	M IH L AH T EH R IY
MILITARY(2)	M IH L IH T EH R IY
MILK	M IH L K
MILK?	M IH L K
MILLENNIA.	M AH L EH N IY AH
MILLION,	M IH L Y AH N
MILLION.	M IH L Y AH N
MILQUETOAST	M IH L K W AH T OW S T
MIND	M AY N D
MIND!	M AY N D
MIND,	M AY N D
MIND-BENDING	M AY N D B EH N D IH NG
MIND.	M AY N D
MINDFUCK!	M AY N D F AH K
MINDS	M AY N D Z
MINE	M AY N
MINE!	M AY N
MINE,	M AY N
MINE.	M AY N
MINES	M AY N Z
MINIATURE	M IH N IY AH CH UH R
MINIATURE(2)	M IH N IH CH UH R
MINIMUM	M IH N AH M AH M
MINING	M AY N IH NG
MINISTRY	M IH N AH S T R IY
MINISTRY(2)	M IH N IH S T R IY
MINNE	M IH N
MINNESOTA?	M IH N EH S AH T AH
MINUTE	M IH N AH T
MINUTE(2)	M AY N UW T
MINUTE(3)	M AY N Y UW T
MINUTE,	M IH N AH T
MINUTE.	M IH N AH T
MINUTES	M IH N AH T S
MINUTES!	M IH N AH T S
MINUTES.	M IH N AH T S
MISERY.	M IH Z ER IY
MISS	M IH S
MISS.	M IH S
MISS?	M IH S
MISSED	M IH S T
MISSING	M IH S IH NG
MISSING.	M IH S IH NG
MISTAKE	M IH S T EY K
MISTAKE,	M IH S T EY K
MISTAKE.	M IH S T EY K
MISTAKES	M IH S T EY K S
MISTER!	M IH S T ER
MISTER,	M IH S T ER
MISUNDERSTANDING.	M IH S AH N D ER S T AE N D IH NG
MITTENS.	M IH T AH N Z
MIXED	M IH K S T
MM	EH M
MM!	EH M EH M
MM,	EH M EH M
MM.	EH M EH M
MMM!	EH M EH M EH M
MMM.	EH M EH M EH M
MNEMONIC	N IH M AA N IH K
MNEMONIC(2)	N IY M AA N IH K
MO	M OW
MO-MO!	M OW M OW
MODEL	M AA D AH L
MODIFICATIONS	M AA D AH F AH K EY SH AH N Z
MOJITOS.	M AA JH AH T AH Z
MOM	M AA M
MOM!	M AA M
MOM,	M AA M
MOM.	M AA M
MOM?	M AA M
MOMENT	M OW M AH N T
MONEY	M AH N IY
MONEY'S	M AH N IY Z
MONEY.	M AH N IY
MONITOR	M AA N AH T ER
MONITOR,	M AA N AH T ER
MONKEY	M AH NG K IY
MONSTER	M AA N S T ER
MONSTER!	M AA N S T ER
MONSTER.	M AA N S T ER
MONSTERS,	M AA N S T ER Z
MONSTERS.	M AA N S T ER Z
MONTH'S	M AH N TH S
MONTH.	M AH N TH
MONTHS	M AH N TH S
MONTHS.	M AH N TH S
MONUMENT	M AA N Y UW M AH N T
MONUMENT(2)	M AA N Y AH M AH N T
MOODY.	M UW D IY
MOON	M UW N
MOP	M AA P
MORE	M AO R
MORE.	M OW R
MORNING	M AO R N IH NG
MORNING,	M AO R N IH NG
MORNING.	M AO R N IH NG
MORNING?	M AO R N IH NG
MORTIES.	M AO R T IY Z
MORTIMER	M AO R T IH M ER
MORTY	M AO R T IY
MORTY!	M AO R T IY
MORTY'S	M AO R T IY Z
MORTY,	M AO R T IY
MORTY.	M AO R T IY
MORTY?	M AO R T IY
MORTY?!	M AO R T IY
MOST	M OW S T
MOST(2)	M OW S
MOST.	M OW S T
MOTHER	M AH DH ER
MOTHER'S	M AH DH ER Z
MOTHER.	M AH DH ER
MOTHERF	M AA TH AH R F
MOTHERFUCKER!	M AH DH ER F AH K ER
MOTHERFUCKER?	M AH DH ER F AH K ER
MOTION	M OW SH AH N
MOTOR	M OW T ER
MOUNTAIN?	M AW N T AH N
MOUNTAINS.	M AW N T AH N Z
MOUTH	M AW TH
MOUTH,	M AW TH
MOUTH.	M AW TH
MOVE	M UW V
MOVE!	M UW V
MOVE,	M UW V
MOVE.	M UW V
MOVED	M UW V D
MOVIE	M UW V IY
MOVIE,	M UW V IY
MOVIE.	M UW V IY
MOVIE?	M UW V IY
MOVIES	M UW V IY Z
MOVING	M UW V IH NG
MOYNIHAN	M OY N IH HH AE N
MOYNIHAN!	M OY N AH AH N
MR.	M IH S T ER
MRS.	M IH S IH Z
MUCH	M AH CH
MUCH,	M AH CH
MUCH.	M AH CH
MULTIPHASE	M AH L T AY F EY Z
MURDER	M ER D ER
MURDER.	M ER D ER
MURDERS	M ER D ER Z
MURRAY	M ER IY
MURRAY(2)	M AH R IY
MURRAY.	M AH R EY IY
MUSCULAR	M AH S K Y AH L ER
MUSEUM	M Y UW Z IY AH M
MUSIC	M Y UW Z IH K
MUSIC.	M Y UW Z IH K
MUSIC?	M Y UW Z IH K
MUSKEGON.	M AH S AH G AH N
MUST	M AH S T
MUST,	M AH S T
MUSTACHES,	M AH S T AE SH IH Z
MUTE	M Y UW T
MUTILATION	M Y UW T AH L EY SH AH N
MY	M AY
MY,	M AY
MYSELF	M AY S EH L F
MYSELF!	M AY S EH L F
MYSELF,	M AY S EH L F
MYSELF.	M AY S EH L F
MYSELF?	M AY S EH L F
MYSTERIES	M IH S T ER IY Z
MYSTERIOUS	M IH S T IH R IY AH S
MYSTERY.	M IH S T AH R IY
N-NO	EH N N OW
N.A.S.A.	EH N EY EH S EY
NAILED	N EY L D
NAKED	N EY K AH D
NAKED!	N EY K AH D
NAME	N EY M
NAME'S	N EY M Z
NAME,	N EY M
NAME.	N EY M
NAME?	N EY M
NAMED	N EY M D
NAMES	N EY M Z
NAMES?	N EY M Z
NANOBOTIC	N AE N AH B AH T AH K
NAR	N AA R
NAR,	N AA R
NARCISSISTICALLY	N AA R S AH S IH S T AH K AE L IY
NATALIE	N AE T AH L IY
NATIONAL	N AE SH AH N AH L
NATIONAL(2)	N AE SH N AH L
NATIONALLY	N AE SH AH N AH L IY
NATIONALLY(2)	N AE SH N AH L IY
NATURE	N EY CH ER
NATURE'S	N EY CH ER Z
NEAR	N IH R
NEARLY	N IH R L IY
NEAT	N IY T
NEAT.	N IY T
NECESSARY	N EH S AH S EH R IY
NECESSARY.	N EH S AH S EH R IY
NECK,	N EH K
NEED	N IY D
NEEDED	N IY D AH D
NEEDED(2)	N IY D IH D
NEEDFUL	N IY D F AH L
NEEDFUL,	N IY D F AH L
NEEDFUL.	N IY D F AH L
NEEDS	N IY D Z
NEGATIVE	N EH G AH T IH V
NEGLIGENT,	N EH G L IH JH AH N T
NEGOTIATE	N AH G OW SH IY EY T
NEGOTIATE(2)	N IH G OW SH IY EY T
NEIGHBORHOOD	N EY B ER HH UH D
NERVES,	N ER V Z
NERVOUS	N ER V AH S
NERVOUS.	N ER V AH S
NEUTRALIZE	N UW T R AH L AY Z
NEUTRINO	N UW T R IY N OW
NEVER	N EH V ER
NEVER!	N EH V ER
NEW	N UW
NEW(2)	N Y UW
NEW,	N UW
NEWMAN	N UW M AH N
NEWS	N UW Z
NEWS(2)	N Y UW Z
NEWS,	N UW Z
NEWS.	N UW Z
NEWSPAPER.	N UW Z P EY P ER
NEXT	N EH K S T
NEXT(2)	N EH K S
NEXT?	N EH K S T
NICE	N AY S
NICE(2)	N IY S
NICE!	N AY S
NICE,	N AY S
NICE-LOOKING	N AY S L UH K IH NG
NICE.	N AY S
NIGHT	N AY T
NIGHT.	N AY T
NIGHT?	N AY T
NIGHTMARE!	N AY T M EH R
NIGHTMARE,	N AY T M EH R
NIGHTMARE.	N AY T M EH R
NIGHTS	N AY T S
NIGHTTIME	N AY T T AY M
NINE	N AY N
NINE?	N AY N
NINETIES.	N AY N T IY Z
NIPPLE	N IH P AH L
NIPPLE!	N IH P AH L
NIPPLE,	N IH P AH L
NIPPLE.	N IH P AH L
NIPPLE?	N IH P AH L
NIPS,	N IH P S
NO	N OW
NO!	N OW
NO,	N OW
NO.	N OW
NO?	N OW
NOBEL	N OW B EH L
NOBLE	N OW B AH L
NOBODY	N OW B AA D IY
NOBODY(2)	N OW B AH D IY
NOBODY'S	N OW B AA D IY Z
NOBODY'S(2)	N OW B AH D IY Z
NOBODY.	N OW B AA D IY
NOISE.	N OY Z
NOISES,	N OY Z IH Z
NOMINATE	N AA M AH N AH T
NOMINATE(2)	N AA M AH N EY T
NOMINATEDFOR	N AA M AH N EY T IH D F AO R
NON-STOP	N AA N S T AA P
NONE	N AH N
NONSENSE	N AA N S EH N S
NONSENSE,	N AA N S EH N S
NONSENSICAL	N AA N S EH N S IH K AH L
NOOPERS	N UW P AH R Z
NOOPERS,	N UW P AH R Z
NOOPERS.	N UW P AH R Z
NOPE.	N OW P
NORMAL	N AO R M AH L
NORMAL,	N AO R M AH L
NORMAL.	N AO R M AH L
NORMALLY,	N AO R M AH L IY
NORTH	N AO R TH
NORTH.	N AO R TH
NOSE	N OW Z
NOT	N AA T
NOT!	N AA T
NOT,	N AA T
NOT.	N AA T
NOT?	N AA T
NOTED.	N OW T IH D
NOTHING	N AH TH IH NG
NOTHING'S	N AH TH IH NG Z
NOTHING,	N AH TH IH NG
NOTHING.	N AH TH IH NG
NOTHING?	N AH TH IH NG
NOTICE	N OW T AH S
NOTICE(2)	N OW T IH S
NOTICED	N OW T IH S T
NOTICED.	N OW T AH S T
NOTIFY	N OW T AH F AY
NOTIFYING	N OW T AH F AY IH NG
NOTTHEM.	N AA T TH AH M
NOUNS	N AW N Z
NOVEL	N AA V AH L
NOVEL,	N AA V AH L
NOVEL.	N AA V AH L
NOW	N AW
NOW!	N AW
NOW,	N AW
NOW.	N AW
NOW?	N AW
NOWHERE,	N OW W EH ER
NUDITY.	N UW D AH T IY
NUMBER	N AH M B ER
NUMBER,	N AH M B ER
NURSERY.	N ER S AH R IY
NURSING	N ER S IH NG
NUT	N AH T
NUTJOB,	N AH T JH AA B
NUTS!	N AH T S
NUTS,	N AH T S
NUTS?	N AH T S
O	OW
O'CLOCK.	AH K L AA K
O-O-OKAY.	OW OW OW K EY
O-OF	OW AH V
O-OKAY,	OW OW K EY
O-ONCE	OW W AH N S
OBAMA.	AA B AH M AH
OBSESS	AH B S EH S
OBSESSION	AH B S EH SH AH N
OBSOLETE.	AA B S AH L IY T
OBVIOUS	AA B V IY AH S
OBVIOUS,	AA B V IY AH S
OBVIOUSLY	AA B V IY AH S L IY
OBVIOUSLY,	AA B V IY AH S L IY
OF	AH V
OF,	AH V
OF.	AH V
OFF	AO F
OFF!	AO F
OFF,	AO F
OFF.	AO F
OFFENSE	AH F EH N S
OFFER,	AO F ER
OFFICIAL	AH F IH SH AH L
OFFICIALLY	AH F IH SH AH L IY
OFFLINE.	AO F L AY N
OH	OW
OH!	OW
OH,	OW
OH-HO-HO!	OW HH OW HH OW
OH.	OW
OHH!	AA HH
OHH,	AA HH
OHH.	AA HH
OHHHH!	AA HH
OHHHHH!	AA HH
OHHHHHH!	AA HH
OHHHHHH.	AA HH
OHUM	AA HH AH M
OKAY	OW K EY
OKAY!	OW K EY
OKAY,	OW K EY
OKAY.	OW K EY
OKAY?	OW K EY
OLD	OW L D
OLD-SCHOOL	OW L D S K UW L
OLIVES	AA L IH V Z
OLYMPICS.	AH L IH M P AH S Z
ON	AA N
ON(2)	AO N
ON!	AO N
ON,	AO N
ON.	AO N
ON?	AO N
ONCE	W AH N S
ONCE,	W AH N S
ONCE.	W AH N S
ONCE?	W AH N S
ONCEIN	AA N S IY N
ONE	W AH N
ONE(2)	HH W AH N
ONE'S	W AH N Z
ONE,	W AH N
ONE-HANDED	W AH N HH AE N D AH D
ONE-HUNDREDTH	W AH N HH AH N D R AH D TH
ONE-SEVENTH	W AH N S EH V AH N TH
ONE.	W AH N
ONE?	W AH N
ONES	W AH N Z
ONES.	W AH N Z
ONLINE,	AO N L AY N
ONLINE.	AO N L AY N
ONLY	OW N L IY
ONLY!	OW N L IY
ONLY.	OW N L IY
ONTO	AA N T UW
ONTO(2)	AO N T UW
OOF!	UW F
OOF.	UW F
OOH!	UW
OOH,	UW
OOH.	UW
OOOH!	UW OW
OOPS.	UW P S
OP	AA P
OP(2)	AO P
OPEN	OW P AH N
OPEN,	OW P AH N
OPEN-AND-SHUT	OW P AH N AH N D SH AH T
OPEN.	OW P AH N
OPENED	OW P AH N D
OPERA	AA P R AH
OPERATE	AA P ER EY T
OPERATE(2)	AO P ER EY T
OPERATES	AA P ER EY T S
OPERATING	AA P ER EY T IH NG
OPERATING(2)	AO P ER EY T IH NG
OPERATION.	AA P ER EY SH AH N
OPINION	AH P IH N Y AH N
OPINION,	AH P IH N Y AH N
OPINION.	AH P IH N Y AH N
OPPORTUNITY	AA P ER T UW N AH T IY
OPPORTUNITY,	AA P ER T UW N AH T IY
OPPOSITE	AA P AH Z IH T
OPPOSITE.	AA P AH Z AH T
OR	AO R
OR(2)	ER
OR,	AO R
ORDER	AO R D ER
ORDER.	AO R D ER
ORDERING	AO R D ER IH NG
ORDERS	AO R D ER Z
ORGAN	AO R G AH N
ORIGIN	AO R AH JH AH N
ORIGINAL	ER IH JH AH N AH L
OTHER	AH DH ER
OTHER,	AH DH ER
OTHER.	AH DH ER
OUCH.	AW CH
OUR	AW ER
OUR(2)	AW R
OUR(3)	AA R
OURFAMOUS	AH R F AH M AH S
OURS!	AW ER Z
OURSELVES	AW ER S EH L V Z
OURSELVES(2)	AA R S EH L V Z
OURSELVES,	AW ER S EH L V Z
OUT	AW T
OUT!	AW T
OUT,	AW T
OUT.	AW T
OUT?	AW T
OUTBREAK.	AW T B R EY K
OUTBURST	AW T B ER S T
OUTDONE	AW T D AH N
OUTJUST	AW T JH AH S T
OUTRANK	AW T R AE NG K
OUTSIDE	AW T S AY D
OUTSIDE.	AW T S AY D
OUTSIDE?	AW T S AY D
OUTSMART	AW T S M AA R T
OVER	OW V ER
OVER,	OW V ER
OVER.	OW V ER
OVERHAULED	OW V ER HH AO L D
OVERHEAD.	OW V ER HH EH D
OVERREACTED.	OW V ER R IY AE K T IH D
OVERSIZED	OW V ER S AY Z D
OVERSTEP	OW V ER S T EH P
OW!	OW
OWN	OW N
OWN,	OW N
OWN.	OW N
OWN?	OW N
OXYGEN.	AA K S IH JH AH N
OXYTOCIN.	AA K S IH T AH S AH N
P-PORTAL	P IY P AO R T AH L
PACK	P AE K
PACKAGE	P AE K AH JH
PACKAGE(2)	P AE K IH JH
PADDING,	P AE D IH NG
PAGAN	P EY G AH N
PAGE	P EY JH
PAID	P EY D
PAIN	P EY N
PAIN,	P EY N
PAIN.	P EY N
PAINTED	P EY N T AH D
PAINTED(2)	P EY N T IH D
PAINTED(3)	P EY N AH D
PAINTED(4)	P EY N IH D
PAIR	P EH R
PAL.	P AE L
PALICKY	P EY L IH K S IY
PALICKY.	P EY L IH K S IY
PAN	P AE N
PANCAKES	P AE N K EY K S
PANCAKES!	P AE N K EY K S
PANCAKES'	P AE N K EY K S
PANCAKES,	P AE N K EY K S
PANCREAS	P AE N K R IY AH S
PANCREAS.	P AE NG K R IY Z
PANCREAS?	P AE NG K R IY Z
PANDA	P AE N D AH
PANICKING.	P AE N IH K IH NG
PANTS	P AE N T S
PANTS!	P AE N T S
PANTS,	P AE N T S
PANTS.	P AE N T S
PANTSDAWG.	P AE N T S D AH G
PAPER	P EY P ER
PARACHUTE.	P AE R AH SH UW T
PARADISE	P EH R AH D AY S
PARADISE.	P AE R AH D AY S
PARADOX!	P AE R AH D AA K S
PARALLEL	P EH R AH L EH L
PARDON,	P AA R D AH N
PARENTS	P EH R AH N T S
PARENTS.	P AE R AH N T S
PARK	P AA R K
PARK!	P AA R K
PARK'S	P AA R K S
PARK,	P AA R K
PARK.	P AA R K
PARK?	P AA R K
PART	P AA R T
PART-TIME	P AA R T T AY M
PARTNER,	P AA R T N ER
PARTNER.	P AA R T N ER
PARTNERING	P AA R T N ER IH NG
PARTNERS.	P AA R T N ER Z
PARTS	P AA R T S
PARTS,	P AA R T S
PARTY	P AA R T IY
PARTY?	P AA R T IY
PASS	P AE S
PASSAGE	P AE S AH JH
PASSAGE(2)	P AE S IH JH
PASSED	P AE S T
PASSIVE-AGGRESSION,	P AE S IH V AH G R EH SH AH N
PASSOVER.	P AE S OW V ER
PAST	P AE S T
PATCH?	P AE CH
PATENT	P AE T AH N T
PATH	P AE TH
PATHETIC	P AH TH EH T IH K
PATHETIC,	P AH TH EH T IH K
PATHWAY	P AE TH W EY
PATRIARCHAL!	P EY T R IY AA R K AH L
PAUL	P AO L
PAUSE	P AO Z
PAW.	P AO
PAWN	P AO N
PAY	P EY
PAY!	P EY
PAYING	P EY IH NG
PAYS	P EY Z
PEACE.	P IY S
PEANUT	P IY N AH T
PEARL	P ER L
PEDAL	P EH D AH L
PEED	P IY D
PEEING	P IY IH NG
PEELED	P IY L D
PENCER,	P EH N S AH R
PENIS	P IY N IH S
PENIS.	P EH N IY Z
PEOPLE	P IY P AH L
PEOPLE!	P IY P AH L
PEOPLE'D	P IY P AH L D
PEOPLE'S	P IY P AH L Z
PEOPLE,	P IY P AH L
PEOPLE.	P IY P AH L
PEOPLE?	P IY P AH L
PERCENT	P ER S EH N T
PERCENT.	P ER S EH N T
PERCENTAGE	P ER S EH N T AH JH
PERCENTAGE(2)	P ER S EH N AH JH
PERCENTAGE(3)	P ER S EH N T IH JH
PERCENTAGE(4)	P ER S EH N IH JH
PERFECT	P ER F EH K T
PERFECT(2)	P ER F IH K T
PERFECT,	P ER F AH K T
PERFECT.	P ER F AH K T
PERFECTLY	P ER F AH K T L IY
PERFECTLY(2)	P ER F AH K L IY
PERFORM	P ER F AO R M
PERFORMING	P ER F AO R M IH NG
PERHAPS	P ER HH AE P S
PERMITTED	P ER M IH T AH D
PERMITTED(2)	P ER M IH T IH D
PERSEVERED	P ER S AH V IH R D
PERSON	P ER S AH N
PERSON.	P ER S AH N
PERSONAL.	P ER S AH N AH L
PERSONALLY.	P ER S AH N AH L IY
PERVY	P AH R V IY
PET	P EH T
PETE'S	P IY T S
PETTY!	P EH T IY
PFFT!	P IY EH F EH F T IY
PHASE	F EY Z
PHIL	F IH L
PHONE	F OW N
PHONE!	F OW N
PHONE.	F OW N
PHONES,	F OW N Z
PHRASE?	F R EY Z
PI,	P AY
PI.	P AY
PICK	P IH K
PICKING	P IH K IH NG
PICKLES	P IH K AH L Z
PICKLES,	P IH K AH L Z
PICTURE.	P IH K CH ER
PIECE	P IY S
PIGGYBACKING	P IH G IY B AE K IH NG
PILLOW,	P IH L OW
PILLOW.	P IH L OW
PILLS	P IH L Z
PILOT.	P AY L AH T
PIN	P IH N
PING-PONG	P IH NG P AO NG
PINK	P IH NG K
PIRATES	P AY R AH T S
PIRATES?	P AY R AH T S
PISS	P IH S
PITCH	P IH CH
PITCH!	P IH CH
PITCH.	P IH CH
PITCHED	P IH CH T
PLACE	P L EY S
PLACE,	P L EY S
PLACE.	P L EY S
PLACE?	P L EY S
PLACED	P L EY S T
PLACES	P L EY S AH Z
PLACES(2)	P L EY S IH Z
PLAGUE!	P L EY G
PLAN	P L AE N
PLAN,	P L AE N
PLAN.	P L AE N
PLANE!	P L EY N
PLANE,	P L EY N
PLANET	P L AE N AH T
PLANET!	P L AE N AH T
PLANET,	P L AE N AH T
PLANET.	P L AE N AH T
PLANETS.	P L AE N AH T S
PLANETS?	P L AE N AH T S
PLANNED	P L AE N D
PLANS	P L AE N Z
PLAY	P L EY
PLAYED	P L EY D
PLAYING	P L EY IH NG
PLEASE	P L IY Z
PLEASE!	P L IY Z
PLEASE,	P L IY Z
PLEASE.	P L IY Z
PLEASURE	P L EH ZH ER
PLEASURE'S	P L EH ZH ER Z
PLENTY	P L EH N T IY
PLENTY(2)	P L EH N IY
PLOT	P L AA T
PLUCK	P L AH K
PLUS	P L AH S
PLUS,	P L AH S
PLUS.	P L AH S
PLUTO	P L UW T OW
PLUTO'S	P L UW T OW Z
PLUTO,	P L UW T OW
PLUTO-BEL	P L UW T OW B EH L
PLUTO-NAMO	P L UW T OW N AE M OW
PLUTO-QUAKES,	P L UW T OW K W EY K S
PLUTO.	P L UW T OW
PLUTO?	P L UW T OW
PLUTONIANS	P L UW T OW N IY AH N Z
PLUTONIANS.	P L UW T OW N IY AH N Z
PLUTONIC	P L UW T AA N IH K
PLUTONIUM	P L UW T OW N IY AH M
PLUTONIUM.	P L UW T OW N IY AH M
POINT	P OY N T
POINT,	P OY N T
POINT.	P OY N T
POINTY.	P OY N T IY
POISON	P OY Z AH N
POISONOUS	P OY Z AH N AH S
POLICE	P AH L IY S
POLICE?	P AH L IY S
POLICY	P AA L AH S IY
POLITE,	P AH L AY T
POLITICS	P AA L AH T IH K S
POMPOUS,	P AA M P AH S
PONCHO!	P AA N CH OW
PONCHO,	P AA N CH OW
PONCHO.	P AA N CH OW
PONCHO?	P AA N CH OW
POOF.	P UW F
POOP	P UW P
POOPED	P UW P T
POOPY	P UW P IY
POOR	P UW R
POOR,	P UH R
POOR?	P UH R
POP	P AA P
POP,	P AA P
POP.	P AA P
POPPIES,	P AA P IY Z
POPULAR	P AA P Y AH L ER
POPULATED	P AA P Y AH L EY T AH D
POPULATION.	P AA P Y AH L EY SH AH N
PORTAL	P AO R T AH L
PORTAL.	P OW R T AH L
PORTAL?	P OW R T AH L
POSITE	P AH S AY T
POSITION.	P AH Z IH SH AH N
POSSE.	P AA S IY
POSSESSED	P AH Z EH S T
POSSIBILITIES,	P AA S AH B IH L AH T IY Z
POSSIBILITIES.	P AA S AH B IH L AH T IY Z
POSSIBILITY	P AA S AH B IH L AH T IY
POSSIBLE	P AA S AH B AH L
POSSIBLE?	P AA S AH B AH L
POSSIBLY	P AA S AH B L IY
POSTING	P OW S T IH NG
POTION	P OW SH AH N
POUR	P AO R
POWER	P AW ER
POWER.	P AW ER
POWERFUL	P AW ER F AH L
POWERFUL,	P AW ER F AH L
POWERS	P AW ER Z
POWERS.	P AW ER Z
PPEARS	P IY R Z
PPEN?!	P EH N
PRACTICE-KISS	P R AE K T IH S K IH S
PRAISE	P R EY Z
PRAYING	P R EY IH NG
PRAYING-MANTIS	P R EY IH NG M AE N T IH S
PRECIOUS	P R EH SH AH S
PRECISE	P R IH S AY S
PRECISE(2)	P R IY S AY S
PREDATOR,	P R IY D EY T ER
PREDICTABLE?	P R IH D IH K T AH B AH L
PREDILECTIONS	P R EH D AH L EH K SH AH N Z
PREGNANCY.	P R EH G N AH N S IY
PREGNANT	P R EH G N AH N T
PREGNANT!	P R EH G N AH N T
PREGNANT,	P R EH G N AH N T
PREGNANT.	P R EH G N AH N T
PREMIUM	P R IY M IY AH M
PREPOSTEROUS.	P R IH P AA S T AH R AH S
PRESIDENT	P R EH Z IH D AH N T
PRESS	P R EH S
PRESSURE	P R EH SH ER
PRETEND	P R IY T EH N D
PRETTIEST	P R IH T IY AH S T
PRETTY	P R IH T IY
PREVIEW	P R IY V Y UW
PREVIOUS	P R IY V IY AH S
PREY	P R EY
PRICE	P R AY S
PRICE.	P R AY S
PRICES,	P R AY S IH Z
PRIMITIVE	P R IH M AH T IH V
PRIMITIVE(2)	P R IH M IH T IH V
PRINCIPAL	P R IH N S AH P AH L
PRIORITY	P R AY AO R AH T IY
PRISON	P R IH Z AH N
PRISON.	P R IH Z AH N
PRISON?	P R IH Z AH N
PRIVATE?	P R AY V AH T
PRIVATES?	P R AY V AH T S
PRIZE	P R AY Z
PRIZE.	P R AY Z
PROBABLY	P R AA B AH B L IY
PROBLEM	P R AA B L AH M
PROBLEM,	P R AA B L AH M
PROBLEM.	P R AA B L AH M
PROC	P R AA K
PROCEED	P R AH S IY D
PROCEED(2)	P R OW S IY D
PROCEED(3)	P ER S IY D
PROCESS	P R AA S EH S
PROCESS(2)	P R AO S EH S
PROCESS,	P R AA S EH S
PROCESSING	P R AA S EH S IH NG
PROCESSING,	P R AA S EH S IH NG
PROCESSORS	P R AA S EH S ER Z
PROGRAMING	P R OW G R AE M IH NG
PROGRAMMED	P R OW G R AE M D
PROGRAMS	P R OW G R AE M Z
PROJECT	P R AA JH EH K T
PROJECT.	P R AA JH EH K T
PROJECT?	P R AA JH EH K T
PROJECTION	P R AA JH EH K SH AH N
PROLONGED	P R AH L AO NG D
PROLONGING	P R OW L AO NG IH NG
PROM	P R AA M
PROMISE	P R AA M AH S
PROMOTED!	P R OW M OW T IH D
PROOF.	P R UW F
PROPER	P R AA P ER
PROPOSITION	P R AA P AH Z IH SH AH N
PROUD	P R AW D
PROVERBIAL	P R AH V ER B IY AH L
PROWESS	P R AW AH S
PSST,	P IY EH S EH S T IY
PUBERTY?	P Y UW B ER T IY
PUBLISHED	P AH B L IH SH T
PUFFY	P AH F IY
PUH!	P UW
PUKE!	P Y UW K
PUKE.	P Y UW K
PULL	P UH L
PULLED	P UH L D
PULLING	P UH L IH NG
PUMP	P AH M P
PUMPKIN	P AH M P K IH N
PUMPKIN(2)	P AH M K IH N
PUMPKINS,	P AH M P K AH N Z
PUN	P AH N
PUNCHES,	P AH N CH IH Z
PUNISH	P AH N IH SH
PUNISHABLE	P AH N IH SH AH B AH L
PUNISHED	P AH N IH SH T
PUNISHMENT	P AH N IH SH M AH N T
PUNK	P AH NG K
PURE	P Y UH R
PURGE	P ER JH
PURPOSE	P ER P AH S
PURPOSE.	P ER P AH S
PURPOSE?	P ER P AH S
PURSUIT	P ER S UW T
PUSHBACK	P UH SH B AE K
PUSSY	P UH S IY
PUT	P UH T
PUTS	P UH T S
PUTT	P AH T
PUTTING	P AH T IH NG
PUTTING(2)	P UH T IH NG
Q,	K Y UW
Q-QUICKLY?	K Y UW K W IH K L IY
QUALITY	K W AA L AH T IY
QUANTUM	K W AA N T AH M
QUARANTINED	K W AO R AH N T IY N D
QUARANTINED(2)	K W AO R AH N T AY N D
QUARKS	K W AA R K S
QUARKS,	K W AO R K S
QUEST,	K W EH S T
QUESTION	K W EH S CH AH N
QUESTION(2)	K W EH SH AH N
QUESTION,	K W EH S CH AH N
QUESTION.	K W EH S CH AH N
QUESTIONING,	K W EH S CH AH N IH NG
QUESTIONS	K W EH S CH AH N Z
QUESTIONS!	K W EH S CH AH N Z
QUESTIONS,	K W EH S CH AH N Z
QUICK	K W IH K
QUICK,	K W IH K
QUICK.	K W IH K
QUICK?	K W IH K
QUICKER	K W IH K ER
QUIET.	K W AY AH T
QUINTONS	K W IH N T AO N Z
QUIT	K W IH T
QUIT!	K W IH T
QUITE	K W AY T
QUIZ.	K W IH Z
QUOTE-UNQUOTE	K W OW T AH N K W OW T
R,	AA R
R-R-REUBEN'S	AA R AA R R UW B AH N Z
R-RELATIVE	AA R R EH L AH T IH V
R-ROAD	AA R R OW D
RABBIT	R AE B AH T
RABBIT(2)	R AE B IH T
RACETRACK	R EY S T R AE K
RACIAL	R EY SH AH L
RACING.	R EY S IH NG
RACKET	R AE K IH T
RADIO.	R EY D IY OW
RADIOS,	R EY D IY OW Z
RAILS.	R EY L Z
RAINING	R EY N IH NG
RAISE	R EY Z
RAISED	R EY Z D
RALLY,	R AE L IY
RALPH	R AE L F
RAN	R AE N
RANDOLPH	R AE N D AA L F
RANDOM	R AE N D AH M
RANDOM,	R AE N D AH M
RAP	R AE P
RAPE	R EY P
RAPEY.	R EY P IY
RAPPER	R AE P ER
RAPPER,	R AE P ER
RAPPING	R AE P IH NG
RARE	R EH R
RASCAL.	R AE S K AH L
RATHER	R AE DH ER
RATHER(2)	R AH DH ER
RATIONAL	R AE SH AH N AH L
RATIONAL(2)	R AE SH N AH L
RATS!	R AE T S
RATTLESNAKE,	R AE T AH L S N EY K
RAY	R EY
RE-EVALUATE	R EY IH V AE L Y UW EY T
REACHES	R IY CH AH Z
REACHES(2)	R IY CH IH Z
REACTION	R IY AE K SH AH N
READ	R EH D
READ(2)	R IY D
READER	R IY D ER
READING	R IY D IH NG
READING(2)	R EH D IH NG
READY	R EH D IY
REAL	R IY L
REAL!	R IY L
REAL,	R IY L
REAL?	R IY L
REALITIES	R IY AE L AH T IY Z
REALITIES,	R IY AE L AH T IY Z
REALITY	R IY AE L AH T IY
REALITY,	R IY AE L AH T IY
REALITY.	R IY AE L AH T IY
REALIZE	R IY AH L AY Z
REALIZED	R IY AH L AY Z D
REALIZING	R IY AH L AY Z IH NG
REALLY	R IH L IY
REALLY(2)	R IY L IY
REALLY,	R IY L IY
REALLY.	R IY L IY
REALLY?	R IY L IY
REAR	R IH R
REASON	R IY Z AH N
REASON.	R IY Z AH N
REASONING!	R IY Z AH N IH NG
REASONING.	R IY Z AH N IH NG
REBOOTS!	R IY B UW T S
RECEIVE	R AH S IY V
RECEIVE(2)	R IH S IY V
RECEIVE(3)	R IY S IY V
RECEIVE.	R IH S IY V
RECENT	R IY S AH N T
RECENTLY	R IY S AH N T L IY
RECENTLY(2)	R IY S AH N L IY
RECIPE	R EH S AH P IY
RECOGNIZES	R EH K AH G N AY Z IH Z
RECTAL	R EH K T AH L
RECTUM,	R IH K T AH M
RECTUMS	R IH K T AH M Z
RED	R EH D
RED,	R EH D
REFRIGERATOR,	R IH F R IH JH ER AH T ER
REFUSED	R AH F Y UW Z D
REFUSED(2)	R IH F Y UW Z D
REGULAR	R EH G Y AH L ER
REGULAR(2)	R EY G Y AH L ER
REGULAR,	R EH G Y AH L ER
REGULAR-LEG	R EH G Y AH L ER L EH G
REGULAR-SIZED	R EH G Y AH L ER S AY Z D
REGULARLEGS,	R EH G Y AH L ER L EH G Z
REGULARLEGS.	R EH G Y AH L ER L EH G Z
REHASH	R IY HH AE SH
REJECTED	R IH JH EH K T IH D
REJECTED(2)	R IY JH EH K T AH D
REJECTED(3)	R IY JH EH K T IH D
RELATED	R IH L EY T IH D
RELATED(2)	R IY L EY T AH D
RELATED(3)	R IY L EY T IH D
RELATION.	R IY L EY SH AH N
RELATIONSHIP	R IY L EY SH AH N SH IH P
RELATIVE	R EH L AH T IH V
RELATIVE.	R EH L AH T IH V
RELATIVELY	R EH L AH T IH V L IY
RELAX	R IH L AE K S
RELAX(2)	R IY L AE K S
RELAX!	R IH L AE K S
RELAX,	R IH L AE K S
RELAX.	R IH L AE K S
RELAX?!	R IH L AE K S
RELAXED	R IH L AE K S T
RELAXED(2)	R IY L AE K S T
RELEASED	R IY L IY S T
REMAIN	R IH M EY N
REMAIN(2)	R IY M EY N
REMAINS	R IH M EY N Z
REMAINS(2)	R IY M EY N Z
REMEMBER	R IH M EH M B ER
REMEMBER(2)	R IY M EH M B ER
REMEMBER?	R IH M EH M B ER
REMINDING	R IY M AY N D IH NG
REMOVE,	R IY M UW V
REMOVED	R IY M UW V D
REMOVED.	R IY M UW V D
RENAME	R IY N EY M
RENDERED	R EH N D ER D
RENDERINGS,	R EH N D ER IH NG Z
RENT-FREE	R EH N T F R IY
REPAIR	R IH P EH R
REPLACED	R IY P L EY S T
REPORT	R IY P AO R T
REPORT(2)	R IH P AO R T
REPORTS	R IH P AO R T S
REPORTS(2)	R IY P AO R T S
REPRESENTED	R EH P R AH Z EH N T AH D
REPRESENTED(2)	R EH P R IH Z EH N T IH D
REPRESENTED(3)	R EH P R AH Z EH N AH D
REPRESENTED(4)	R EH P R IH Z EH N IH D
REPTILES	R EH P T AY L Z
REPUBLICANS,	R IH P AH B L IH K AH N Z
REQUEST.	R IY K W EH S T
REQUESTS	R IH K W EH S T S
REQUESTS(2)	R IY K W EH S T S
REQUESTS(3)	R IH K W EH S
REQUESTS(4)	R IY K W EH S
RESEARCH,	R IY S ER CH
RESENT	R IH Z EH N T
RESENT(2)	R IY Z EH N T
RESONATOR,	R EH Z AH N AH T ER
RESONATOR.	R EH Z AH N AH T ER
RESPECT	R IH S P EH K T
RESPECT(2)	R IY S P EH K T
RESPECT,	R IH S P EH K T
RESPIRATORY	R EH S P ER AH T AO R IY
RESPONDING	R IH S P AA N D IH NG
RESPONDING(2)	R IY S P AA N D IH NG
RESPONSIBLE.	R IH S P AA N S AH B AH L
RESPONSIVE,	R IH S P AA N S IH V
REST	R EH S T
RESTING	R EH S T IH NG
RESTRUCTURING.	R IY S T R AH K CH ER IH NG
RESULTANT	R IY Z AH L T AH N T
RETARDED.	R IH T AA R D IH D
RETINAS	R EH T AH N AH Z
RETRIEVER,	R IH T R IY V ER
RETURNED	R IH T ER N D
RETURNED(2)	R IY T ER N D
RETURNING	R IH T ER N IH NG
RETURNING(2)	R IY T ER N IH NG
REUBEN	R UW B AH N
REUBEN'S	R UW B AH N Z
REUBEN,	R IY Y UW B AH N
REUBEN.	R IY Y UW B AH N
REVEALS	R IH V IY L Z
REVEALS(2)	R IY V IY L Z
REVOLVE	R IY V AA L V
REWARDING	R IH W AO R D IH NG
REWARDING(2)	R IY W AO R D IH NG
REX.	R EH K S
RHETORICAL	R IH T AO R IH K AH L
RICH	R IH CH
RICH.	R IH CH
RICK	R IH K
RICK!	R IH K
RICK'S	R IH K S
RICK,	R IH K
RICK.	R IH K
RICK?	R IH K
RICK?!	R IH K
RICKANDMORTY	R IH K AE N D M AO R T IY
RICKANDMORTYADVENTURES	R IH K AH N D M AO R T AY AE D EH N T Y AH R Z
RID	R IH D
RIDE	R AY D
RIDE,	R AY D
RIDE.	R AY D
RIDICULOUS.	R AH D IH K Y AH L AH S
RIDLEY.	R IH D L IY
RIGAMAROLE?	R AH G AE M AH R OW L
RIGHT	R AY T
RIGHT!	R AY T
RIGHT,	R AY T
RIGHT.	R AY T
RIGHT?	R AY T
RIGHTS	R AY T S
RINGS,	R IH NG Z
RIP	R IH P
RIP-OFF	R IH P AO F
RIPPED	R IH P T
RISE	R AY Z
RITUAL.	R IH CH AH W AH L
ROAD	R OW D
ROB	R AA B
ROBOT	R OW B AA T
ROBOT(2)	R OW B AH T
ROBOT!	R OW B AA T
ROBOT'S	R OW B AA T S
ROBOT'S(2)	R OW B AH T S
ROBOT,	R OW B AA T
ROBOT.	R OW B AA T
ROBOTS	R OW B AA T S
ROBOTS(2)	R OW B AH T S
ROBOTS!	R OW B AA T S
ROBOTS,	R OW B AA T S
ROBOTS?	R OW B AA T S
ROCK,	R AA K
ROCKS	R AA K S
ROCKY	R AA K IY
RODENT	R OW D AH N T
ROGER	R AA JH ER
ROGUE	R OW G
ROLL	R OW L
ROMANTIC	R OW M AE N T IH K
ROOFIE	R UW F IY
ROOFIE-JUICE	R UW F IY JH UW S
ROOM	R UW M
ROOM,	R UW M
ROOM.	R UW M
ROOM?	R UW M
ROOT	R UW T
ROPE	R OW P
ROPED	R OW P T
ROSEMARY'S	R OW Z M EH R IY Z
ROTTING	R AA T IH NG
ROUGH	R AH F
ROUND?	R AW N D
ROUTE	R UW T
ROUTE(2)	R AW T
ROUTE.	R UW T
ROUTINE	R UW T IY N
ROW,	R OW
RUB	R AH B
RUFFLES	R AH F AH L Z
RUIN	R UW AH N
RUIN(2)	R UW IH N
RUINED	R UW AH N D
RUINED(2)	R UW IH N D
RUINING	R UW IH N IH NG
RULE.	R UW L
RULER	R UW L ER
RULES.	R UW L Z
RULING	R UW L IH NG
RUN	R AH N
RUN!	R AH N
RUN,	R AH N
RUN.	R AH N
RUNNIN'	R AH N IH N
RUNNING	R AH N IH NG
RUNNING.	R AH N IH NG
RUSH.	R AH SH
S	EH S
S-S-S-SUMMER!	EH S EH S EH S S AH M ER
S-SAMANTHA.	EH S S AH M AE N TH AH
S-SIDE	EH S S AY D
SABOTAGED.	S AE B AH T AA ZH D
SACRED!	S EY K R AH D
SACRIFICE	S AE K R AH F AY S
SACS	S AE K S
SAFARI!	S AH F AA R IY
SAFE	S EY F
SAFE,	S EY F
SAFER	S EY F ER
SAGET.	S AE JH AH T
SAID	S EH D
SAID,	S EH D
SAKE!	S EY K
SALARY	S AE L ER IY
SALEM.	S AE L AH M
SAME	S EY M
SANCHEZ	S AE N CH EH Z
SANCHEZ!	S AE NG K AH Z
SANCHEZ,	S AE NG K AH Z
SAND,	S AE N D
SANDWICH	S AE N D W IH CH
SANDWICH(2)	S AE N W IH CH
SANDWICH(3)	S AE M W IH CH
SANDWICH.	S AE N D W IH CH
SANE	S EY N
SANEST	S EY N AH S T
SANTA	S AE N T AH
SANTA(2)	S AE N AH
SARCASTICALLY,	S AA R K AE S T IH K AH L IY
SATISFACTION	S AE T AH S F AE K SH AH N
SATISFACTION(2)	S AE T IH S F AE K SH AH N
SATISFYING	S AE T IH S F AY IH NG
SATISFYING.	S AE T AH S F AY IH NG
SATURDAY	S AE T ER D IY
SATURDAY(2)	S AE T IH D EY
SATURDAY.	S AE T ER D EY
SAUSAGE	S AO S AH JH
SAUSAGE(2)	S AO S IH JH
SAVE	S EY V
SAVED	S EY V D
SAVED!	S EY V D
SAVIOR,	S EY V Y ER
SAW	S AO
SAY	S EY
SAY,	S EY
SAY.	S EY
SAY?	S EY
SAYING	S EY IH NG
SAYING,	S EY IH NG
SAYING?	S EY IH NG
SAYS	S EH Z
SAYS(2)	S IH Z
SAYS,	S EH Z
SAYS.	S EH Z
SCALING	S K EY L IH NG
SCALPEL	S K AE L P AH L
SCALPEL.	S K AE L P AH L
SCAM	S K AE M
SCAMMERS,	S K AE M AH R Z
SCAN	S K AE N
SCAR	S K AA R
SCARE	S K EH R
SCARIEST	S K EH R IY AH S T
SCARING	S K EH R IH NG
SCARY	S K EH R IY
SCENARIO	S IH N EH R IY OW
SCHOOL	S K UW L
SCHOOL!	S K UW L
SCHOOL,	S K UW L
SCHOOL.	S K UW L
SCHOOL?	S K UW L
SCI-FI	S AY F AY
SCIENCE	S AY AH N S
SCIENCE,	S AY AH N S
SCIENCE.	S AY AH N S
SCIENTIFIC,	S AY AH N T IH F IH K
SCIENTIFICALLY,	S AY AH N T IH F IH K AH L IY
SCIENTIST	S AY AH N T IH S T
SCIENTIST.	S AY AH N T IH S T
SCIENTIST?	S AY AH N T IH S T
SCIENTISTS	S AY AH N T IH S T S
SCIENTISTS(2)	S AY N T IH S T S
SCIENTISTS(3)	S AY N T IH S
SCIENTISTS(4)	S AY AH N T IH S
SCOOT,	S K UW T
SCOTCH	S K AA CH
SCOUTING.	S K AW T IH NG
SCOUTS	S K AW T S
SCRAPS	S K R AE P S
SCREAMING	S K R IY M IH NG
SCREEN	S K R IY N
SCREENS.	S K R IY N Z
SCREW	S K R UW
SCREWDRIVER	S K R UW D R AY V ER
SCREWDRIVER,	S K R UW D R AY V ER
SCREWDRIVER.	S K R UW D R AY V ER
SCREWED	S K R UW D
SCREWED!	S K R UW D
SCROOPY	S K R UW P IY
SEABOARD.	S IY B OW R D
SEAL	S IY L
SEALED	S IY L D
SEARCH	S ER CH
SEASON	S IY Z AH N
SEASON.	S IY Z AH N
SEATTLE.	S IY T AH L
SEC.	S EH K
SECOND,	S EH K AH N D
SECOND?	S EH K AH N D
SECRECY.	S IY K R AH S IY
SECRET?	S IY K R AH T
SECRETS	S IY K R IH T S
SECRETS,	S IY K R AH T S
SECTOR	S EH K T ER
SECURITY	S IH K Y UH R AH T IY
SECURITY!	S IH K Y UH R AH T IY
SECURITY'S	S IH K Y UH R AH T IY Z
SEE	S IY
SEE!	S IY
SEE,	S IY
SEE.	S IY
SEE?	S IY
SEEDS	S IY D Z
SEEDS,	S IY D Z
SEEDS.	S IY D Z
SEEDS?!	S IY D Z
SEEING	S IY IH NG
SEEING?	S IY IH NG
SEEM	S IY M
SEEMS	S IY M Z
SEEN	S IY N
SEIZE	S IY Z
SELECT	S AH L EH K T
SELECTIVE	S AH L EH K T IH V
SELF	S EH L F
SELF-AWARE	S EH L F AH W EH R
SELFISH,	S EH L F IH SH
SELL	S EH L
SELLING	S EH L IH NG
SELLS	S EH L Z
SELLS,	S EH L Z
SELVES	S EH L V Z
SELVES?	S EH L V Z
SEMESTER	S AH M EH S T ER
SENDS	S EH N D Z
SENSATION	S EH N S EY SH AH N
SENSATION?	S EH N S EY SH AH N
SENSE	S EH N S
SENSE,	S EH N S
SENSE.	S EH N S
SENT	S EH N T
SENTENCE	S EH N T AH N S
SENTENCED	S EH N T AH N S T
SENTIENCE	S EH N CH AH N S
SEPARATED	S EH P ER EY T AH D
SEPARATED(2)	S EH P ER EY T IH D
SEPARATION	S EH P ER EY SH AH N
SERIES	S IH R IY Z
SERIOUS	S IH R IY AH S
SERIOUS,	S IH R IY AH S
SERIOUSLY,	S IH R IY AH S L IY
SERIOUSLY.	S IH R IY AH S L IY
SERIOUSLY?	S IH R IY AH S L IY
SERUM	S IH R AH M
SERUM!	S IH R AH M
SERUM.	S IH R AH M
SERUMS,	S IH R AH M Z
SERVANTS.	S ER V AH N T S
SERVE	S ER V
SERVED	S ER V D
SERVICE	S ER V AH S
SERVICE(2)	S ER V IH S
SET	S EH T
SETTING	S EH T IH NG
SETTING.	S EH T IH NG
SETTINGS	S EH T IH NG Z
SETTLED.	S EH T AH L D
SEVEN	S EH V AH N
SEVEN-HORSE	S EH V AH N HH AO R S
SEVEN.	S EH V AH N
SEVENTEEN.	S EH V AH N T IY N
SEVENTY	S EH V AH N T IY
SEVENTY-MILE	S EH V AH N T IY M AY L
SEVERAL	S EH V ER AH L
SEWER	S UW ER
SEX	S EH K S
SEX-DOLL	S EH K S D AA L
SEXUAL	S EH K SH UW AH L
SEXUALLY	S EH K SH UW AH L IY
SHAKE.	SH EY K
SHALL	SH AE L
SHAME.	SH EY M
SHAMEFUL	SH EY M F AH L
SHAPE,	SH EY P
SHAPE.	SH EY P
SHARE	SH EH R
SHARED	SH EH R D
SHARING	SH EH R IH NG
SHARK	SH AA R K
SHARK,	SH AA R K
SHE	SH IY
SHE'LL	SH IY L
SHE'S	SH IY Z
SHE?	SH IY
SHEDDING	SH EH D IH NG
SHELTER	SH EH L T ER
SHH!	EH S EY CH EY CH
SHIELD.	SH IY L D
SHINY	SH AY N IY
SHIP	SH IH P
SHIP.	SH IH P
SHIRT,	SH ER T
SHIT	SH IH T
SHIT!	SH IH T
SHIT'S	SH IH TS
SHIT,	SH IH T
SHIT.	SH IH T
SHMECKELS	SH M EH K AH L Z
SHMECKELS.	SH M EH K AH L Z
SHMECKELS?	SH M EH K AH L Z
SHMLA	SH M L AA
SHMLA.	SH M L AA
SHMLANGELA?	SH M L AE N JH AH L AH
SHMLANTHA!	SH M L AE N TH AH
SHMLONA!	SH M L AA N AH
SHMLONATHAN?	SH M L AA N AH TH AH N
SHMLONY	SH M L AA N IY
SHMLOO'S	SH M L UW Z
SHMLOSS,	SH M L AA S
SHOES	SH UW Z
SHOES,	SH UW Z
SHOES.	SH UW Z
SHOOT	SH UW T
SHOOTING,	SH UW T IH NG
SHOP	SH AA P
SHOP.	SH AA P
SHORT	SH AO R T
SHORTLY.	SH AO R T L IY
SHOT	SH AA T
SHOT,	SH AA T
SHOT.	SH AA T
SHOTGUN	SH AA T G AH N
SHOTS?	SH AA T S
SHOULD	SH UH D
SHOULD!	SH UH D
SHOULD'VE	SH UH D AH V
SHOULD,	SH UH D
SHOULD.	SH UH D
SHOULDERS	SH OW L D ER Z
SHOULDERS,	SH OW L D ER Z
SHOULDERS.	SH OW L D ER Z
SHOULDN'T	SH UH D AH N T
SHOW	SH OW
SHOW.	SH OW
SHOWER	SH AW ER
SHOWER.	SH AW ER
SHOWERS.	SH AW ER Z
SHOWING	SH OW IH NG
SHOWS	SH OW Z
SHOWTIME	SH OW T AY M
SHRANK	SH R AE NG K
SHRINERS,	SH R AY N ER Z
SHRINKAGE	SH R IH NG K IH JH
SHRINKING	SH R IH NG K IH NG
SHRINKS.	SH R IH NG K S
SHUFFLE	SH AH F AH L
SHUT	SH AH T
SHUTTLE.	SH AH T AH L
SICK.	S IH K
SICK?	S IH K
SIDE	S AY D
SIDE.	S AY D
SIDEKICK	S AY D K IH K
SIDEKICK.	S AY D K IH K
SIGHT.	S AY T
SIGNAL	S IH G N AH L
SIGNIFICANT	S AH G N IH F IH K AH N T
SIGNIFICANT(2)	S IH G N IH F IH K AH N T
SILENCE!	S AY L AH N S
SILENT	S AY L AH N T
SILLY,	S IH L IY
SILVER	S IH L V ER
SIMP	S IH M P
SIMPLE	S IH M P AH L
SIMPLE.	S IH M P AH L
SIMULATE	S IH M Y AH L AH T
SIMULATE(2)	S IH M Y AH L EY T
SIMULATED	S IH M Y AH L EY T IH D
SIMULATED!	S IH M Y AH L EY T IH D
SIMULATION	S IH M Y AH L EY SH AH N
SIMULATION!	S IH M Y AH L EY SH AH N
SIMULATION,	S IH M Y AH L EY SH AH N
SIMULATION.	S IH M Y AH L EY SH AH N
SIMULATION?!	S IH M Y AH L EY SH AH N
SIMULATIONS	S IH M Y UW L EY SH AH N Z
SIMULATIONS(2)	S IH M Y AH L EY SH AH N Z
SIMULATOR.	S IH M Y AH L AH T ER
SINCE	S IH N S
SING	S IH NG
SING.	S IH NG
SINGER	S IH NG ER
SINGER?	S IH NG ER
SINGERS	S IH NG ER Z
SINGERS.	S IH NG ER Z
SINGING	S IH NG IH NG
SINGLE	S IH NG G AH L
SINGULAR	S IH NG G Y AH L ER
SINKHOLES,	S IH NG K HH OW L Z
SIP	S IH P
SIR!	S ER
SIR,	S ER
SIR.	S ER
SIREE!	S AY ER IY
SISTER	S IH S T ER
SISTER!	S IH S T ER
SISTER'S	S IH S T ER Z
SISTER.	S IH S T ER
SITTING	S IH T IH NG
SITTING?	S IH T IH NG
SITUATION	S IH CH UW EY SH AH N
SITUATION!	S IH CH AH W EY SH AH N
SITUATION,	S IH CH AH W EY SH AH N
SITUATIONS	S IH CH UW EY SH AH N Z
SITUATIONS.	S IH CH AH W EY SH AH N Z
SIX	S IH K S
SIXTY	S IH K S T IY
SIZE	S AY Z
SIZE!	S AY Z
SIZE,	S AY Z
SK	EH S K
SKARLOG	S K AA R L AH G
SKELETAL	S K EH L AH T AH L
SKILL.	S K IH L
SKILLS,	S K IH L Z
SKIN	S K IH N
SKIP	S K IH P
SKIPPING	S K IH P IH NG
SKY	S K AY
SLAVE	S L EY V
SLAVE,	S L EY V
SLAVE.	S L EY V
SLAVE?	S L EY V
SLEEP	S L IY P
SLEEP,	S L IY P
SLEEP.	S L IY P
SLEEPING	S L IY P IH NG
SLEEPS	S L IY P S
SLEEPY.	S L IY P IY
SLIP	S L IH P
SLIPPELY-SLIPPERY	S L IH P L IY S L IH P ER IY
SLIPPERS.	S L IH P ER Z
SLIPPERY	S L IH P ER IY
SLIPPERY(2)	S L IH P R IY
SLIT	S L IH T
SLOGAN	S L OW G AH N
SLOGAN!	S L OW G AH N
SLOGAN.	S L OW G AH N
SLOP	S L AA P
SLOPPY	S L AA P IY
SLOW	S L OW
SLOW-SPEED	S L OW S P IY D
SLOWER,	S L OW ER
SLOWLY	S L OW L IY
SMALL	S M AO L
SMALL,	S M AO L
SMALLER	S M AO L ER
SMALLEST	S M AO L AH S T
SMART	S M AA R T
SMART!	S M AA R T
SMART,	S M AA R T
SMART.	S M AA R T
SMARTER	S M AA R T ER
SMARTER,	S M AA R T ER
SMARTER.	S M AA R T ER
SMARTEST	S M AA R T AH S T
SMEAR	S M IH R
SMELL	S M EH L
SMELL?	S M EH L
SMIDGE	S M IH JH
SMIDGENS	S M IH JH AH N Z
SMIDGENS.	S M IH JH AH N Z
SMIGGLES.	S M IH G AH L Z
SMITH	S M IH TH
SMITH'S	S M IH TH S
SMITH,	S M IH TH
SMITH.	S M IH TH
SMITH?	S M IH TH
SMOKING?!	S M OW K IH NG
SMOOTHLY	S M UW DH L IY
SNEAKERS	S N IY K ER Z
SNEEZE	S N IY Z
SNEEZY	S N IY Z IY
SNEEZY,	S N IY Z IY
SNEEZY.	S N IY Z IY
SNER	S N EH R
SNIBBLES	S N IH B AH L Z
SNIBBLES.	S N IH B AH L Z
SNIGGLES.	S N IH G AH L Z
SNOWBALL	S N OW B AO L
SNOWBALL,	S N OW B AO L
SNOWBALL.	S N OW B AO L
SNUFFLES	S N AH F AH L Z
SNUFFLES'	S N AH F L Z
SNUFFLES,	S N AH F AH L Z
SNUFFLES.	S N AH F AH L Z
SNUFFLES?	S N AH F AH L Z
SO	S OW
SO!	S OW
SO,	S OW
SO.	S OW
SO?	S OW
SOAK	S OW K
SOAKED	S OW K T
SOAP,	S OW P
SOCIETY	S OW S AY IH T IY
SOFT	S AA F T
SOFT(2)	S AO F T
SOI	S OY
SOIL,	S OY L
SOLAR	S OW L ER
SOLD	S OW L D
SOLID.	S AA L AH D
SOLUTION	S AH L UW SH AH N
SOLUTION,	S AH L UW SH AH N
SOLUTION.	S AH L UW SH AH N
SOLVE	S AA L V
SOLVED.	S AA L V D
SOME	S AH M
SOMEBODY	S AH M B AA D IY
SOMEBODY(2)	S AH M B AH D IY
SOMEBODY'S	S AH M B AA D IY Z
SOMEBODY,	S AH M B AA D IY
SOMEONE	S AH M W AH N
SOMEONE'S	S AH M W AH N Z
SOMEONE?	S AH M W AH N
SOMEONEWAS	S OW M IY AA N Y UW AH Z
SOMETHING	S AH M TH IH NG
SOMETHING!	S AH M TH IH NG
SOMETHING'S	S AH M TH IH NG Z
SOMETHING,	S AH M TH IH NG
SOMETHING.	S AH M TH IH NG
SOMETHING?	S AH M TH IH NG
SOMETIME	S AH M T AY M
SOMETIMES	S AH M T AY M Z
SOMETIMES,	S AH M T AY M Z
SOMETIMES.	S AH M T AY M Z
SOMEWHAT	S AH M W AH T
SOMEWHAT(2)	S AH M HH W AH T
SOMEWHERE	S AH M W EH R
SOMEWHERE,	S AH M W EH ER
SON	S AH N
SON!	S AH N
SON'S	S AH N Z
SON,	S AH N
SON-IN-LAW,	S AH N IH N L AO
SON.	S AH N
SON?	S AH N
SONG!	S AO NG
SONG,	S AO NG
SONS	S AH N Z
SOON.	S UW N
SOPHISTICATED	S AH F IH S T AH K EY T IH D
SOPHISTICATED(2)	S AH F IH S T IH K EY T AH D
SOPHISTICATED.	S AA F IH S T IH K EY T IH D
SORRY	S AA R IY
SORRY,	S AA R IY
SORRY.	S AA R IY
SORRY?	S AA R IY
SORT	S AO R T
SORTS	S AO R T S
SOUL,	S OW L
SOUL.	S OW L
SOULS	S OW L Z
SOUND	S AW N D
SOUNDED	S AW N D IH D
SOUNDS	S AW N D Z
SOUNDS(2)	S AW N Z
SOUP-ED	S UW P EH D
SOUP.	S UW P
SOUTH	S AW TH
SOUTHWEST	S AW TH W EH S T
SOUVENIR,	S UW V AH N IH ER
SOUVENIR.	S UW V AH N IH ER
SP	EH S P
SPACE	S P EY S
SPACECRAFT	S P EY S K R AE F T
SPACESHIP.	S P EY S SH IH P
SPACESHIP?	S P EY S SH IH P
SPARKS	S P AA R K S
SPEAK	S P IY K
SPEAKING	S P IY K IH NG
SPEAKING.	S P IY K IH NG
SPECIAL	S P EH SH AH L
SPECIAL.	S P EH SH AH L
SPECIES	S P IY SH IY Z
SPECIES,	S P IY SH IY Z
SPECIFIC	S P AH S IH F IH K
SPECIFIC(2)	S P IH S IH F IH K
SPECIFIC.	S P IH S IH F IH K
SPECIFIC?	S P IH S IH F IH K
SPECIFICALLY	S P AH S IH F IH K L IY
SPEECH,	S P IY CH
SPEECH.	S P IY CH
SPEED	S P IY D
SPELLED	S P EH L D
SPENCER	S P EH N S ER
SPEND	S P EH N D
SPENDING	S P EH N D IH NG
SPENT	S P EH N T
SPHINCTER	S F IH NG K T AH R
SPIDER	S P AY D ER
SPINES,	S P AY N Z
SPIRAL.	S P AY R AH L
SPIRIT,	S P IH R AH T
SPIRITS	S P IH R IH T S
SPLEEN	S P L IY N
SPLIT	S P L IH T
SPOILERS!	S P OY L ER Z
SPOKEN	S P OW K AH N
SPORTS	S P AO R T S
SPOUTING	S P AW T IH NG
SPREAD.	S P R EH D
SQUARE	S K W EH R
SQUARED?	S K W EH R D
SQUEAKING,	S K W IY K IH NG
SQUEEZE	S K W IY Z
STABILIZED.	S T EY B AH L AY Z D
STAFF.	S T AE F
STAINLESS	S T EY N L AH S
STAIR	S T EH R
STAIR.	S T EH R
STAIRCASE-SHAPED	S T EH R K EY S SH EY P T
STAIRS?	S T EH R Z
STAKE	S T EY K
STAKES	S T EY K S
STALKS	S T AO K S
STALLING.	S T AO L IH NG
STAND	S T AE N D
STAND.	S T AE N D
STANDING	S T AE N D IH NG
STANDING,	S T AE N D IH NG
STANDS	S T AE N D Z
STAR.	S T AA R
STARLIGHT	S T AA R L AY T
STARRING	S T AA R IH NG
START	S T AA R T
START,	S T AA R T
START.	S T AA R T
STARTED	S T AA R T AH D
STARTED(2)	S T AA R T IH D
STARTIN'	S T AA R T AH N
STARTING	S T AA R T IH NG
STARVING.	S T AA R V IH NG
STAT,	S T AE T
STATE-OF-THE-ART	S T EY T AH V DH IH AA R T
STATES	S T EY T S
STATES.	S T EY T S
STATING	S T EY T IH NG
STATION	S T EY SH AH N
STAY	S T EY
STAY.	S T EY
STEAL	S T IY L
STEEL	S T IY L
STEP	S T EH P
STEP.	S T EH P
STEPS	S T EH P S
STEPS.	S T EH P S
STERILIZED	S T EH R AH L AY Z D
STEWART.	S T UW AA R T
STICK	S T IH K
STICKLER	S T IH K AH L ER
STICKLER(2)	S T IH K L ER
STICKS	S T IH K S
STILL	S T IH L
STILL.	S T IH L
STO-O-O-P!	S T OW OW OW P IY
STOCK	S T AA K
STOCKING	S T AA K IH NG
STOCKING,	S T AA K IH NG
STOMACH	S T AH M AH K
STOMACH,	S T AH M AH K
STOMACH.	S T AH M AH K
STONE	S T OW N
STOP	S T AA P
STOP!	S T AA P
STOP.	S T AA P
STOPPED	S T AA P T
STOPS	S T AA P S
STORE	S T AO R
STORE,	S T OW R
STORE.	S T OW R
STOREFRONT	S T AO R F R AA N T
STORES	S T AO R Z
STORY	S T AO R IY
STORY,	S T OW R IY
STOW	S T OW
STRAIGHT	S T R EY T
STRAIGHT.	S T R EY T
STRAIGHTEN	S T R EY T AH N
STRAIN	S T R EY N
STRANDED	S T R AE N D AH D
STRANDED(2)	S T R AE N D IH D
STRANGE	S T R EY N JH
STRANGE.	S T R EY N JH
STRANGER	S T R EY N JH ER
STRANGER.	S T R EY N JH ER
STRAW!	S T R AO
STRAWBERRY	S T R AO B EH R IY
STREET	S T R IY T
STRESS	S T R EH S
STRIKE	S T R AY K
STRIP	S T R IH P
STRIPPING,	S T R IH P IH NG
STRO-O-KE!	S T R OW OW K IY
STROKES	S T R OW K S
STRONG	S T R AO NG
STRONG,	S T R AO NG
STU	S T UW
STUCK.	S T AH K
STUDENT	S T UW D AH N T
STUDENT.	S T UW D AH N T
STUDIED	S T AH D IY D
STUF	S T AH F
STUFF	S T AH F
STUFF,	S T AH F
STUFF.	S T AH F
STUFF?	S T AH F
STUFFED	S T AH F T
STUFFING.	S T AH F IH NG
STUMBLED	S T AH M B AH L D
STUMPY	S T AH M P IY
STUPID	S T UW P AH D
STUPID(2)	S T UW P IH D
STUPID,	S T UW P AH D
STUPID.	S T UW P AH D
STUPID?	S T UW P AH D
STYLE.	S T AY L
SUBCONSCIOUS	S AH B K AA N SH AH S
SUBJUGATION	S AH B JH IH G EY SH AH N
SUBSERVIENT	S AH B S ER V IY AH N T
SUBSTANCE	S AH B S T AH N S
SUCCESSFUL	S AH K S EH S F AH L
SUCCESSFUL,	S AH K S EH S F AH L
SUCH	S AH CH
SUCK	S AH K
SUCK.	S AH K
SUCKA!	S AH K AH
SUCKA.	S AH K AH
SUCKS	S AH K S
SUCKS!	S AH K S
SUDDEN.	S AH D AH N
SUFFERING	S AH F ER IH NG
SUFFERING(2)	S AH F R IH NG
SUFFERING.	S AH F ER IH NG
SUING	S UW IH NG
SUIT	S UW T
SUITABLE	S UW T AH B AH L
SULFUR.	S AH L F ER
SULLIVAN	S AH L AH V AH N
SULLIVAN(2)	S AH L IH V AH N
SULLIVAN,	S AH L AH V AH N
SULLIVAN.	S AH L AH V AH N
SUMMER	S AH M ER
SUMMER!	S AH M ER
SUMMER'S	S AH M ER Z
SUMMER,	S AH M ER
SUMMER.	S AH M ER
SUMMER?	S AH M ER
SUMMER?!	S AH M ER
SUN	S AH N
SUNSHINE	S AH N SH AY N
SUPER	S UW P ER
SUPERINTELLIGENCE	S UW P ER IH N T EH L AH JH AH N S
SUPERIOR,	S UH P IH R IY ER
SUPERIORITY	S UW P IH R IY AO R IH T IY
SUPERMAN.	S UW P ER M AE N
SUPERVISE	S UW P ER V AY Z
SUPPLIED	S AH P L AY D
SUPPORT	S AH P AO R T
SUPPOSE	S AH P OW Z
SUPPOSE,	S AH P OW Z
SUPPOSE.	S AH P OW Z
SUPPOSED	S AH P OW Z D
SURE	SH UH R
SURE,	SH UH R
SURE.	SH UH R
SURFACE	S ER F AH S
SURGEON	S ER JH AH N
SURGEON(2)	S ER JH IH N
SURGEON.	S ER JH AH N
SURGEON?	S ER JH AH N
SURGERY	S ER JH ER IY
SURGERY.	S ER JH AH R IY
SURPRISE	S ER P R AY Z
SURPRISE(2)	S AH P R AY Z
SURPRISE,	S ER P R AY Z
SURPRISE?	S ER P R AY Z
SURROGATES	S ER AH G AH T S
SURROGATES(2)	S ER AH G EY T S
SURROUNDED	S ER AW N D AH D
SURROUNDED(2)	S ER AW N D IH D
SURROUNDING	S ER AW N D IH NG
SURVEILLANCE	S ER V EY L AH N S
SWEAR	S W EH R
SWEATSHOPS.	S W EH T SH AA P S
SWEET	S W IY T
SWEET!	S W IY T
SWEETHEART.	S W IY T HH AA R T
SWEETIE.	S W IY T IY
SWING	S W IH NG
SWING?	S W IH NG
SWORDS	S AO R D Z
SYMBOLIC	S IH M B AA L IH K
SYMPTOM	S IH M P T AH M
SYNDICATED	S IH N D IH K EY T IH D
SYSTEM	S IH S T AH M
SYSTEM.	S IH S T AH M
SYSTEM?	S IH S T AH M
T-T-T-T-T-THAT	T IY T IY T IY T IY T IY DH AE T
T-T-T-THAT	T IY T IY T IY DH AE T
T-T-T-THE	T IY T IY T IY DH AH
T-T-T-THEY	T IY T IY T IY DH EY
T-T-T-THIS	T IY T IY T IY DH IH S
T-T-THAT'S	T IY T IY DH AE T S
T-TAKE	T IY T EY K
T-TELL	T IY T EH L
T-THIS	T IY DH IH S
T-TOMATOES.	T IY T AH M EY T OW Z
T.	T IY
T.,	T IY
TA-TA-TA-TA-TA-TA.	T AA T AA T AA T AA T AA T AA
TABLE,	T EY B AH L
TABLES	T EY B AH L Z
TABLES,	T EY B AH L Z
TABLES.	T EY B AH L Z
TABLOID	T AE B L OY D
TAG.	T AE G
TAIL,	T EY L
TAKE	T EY K
TAKERS?	T EY K ER Z
TAKES	T EY K S
TAKING	T EY K IH NG
TALK	T AO K
TALK!	T AO K
TALK.	T AO K
TALK?	T AO K
TALKED	T AO K T
TALKING	T AO K IH NG
TALKING!	T AO K IH NG
TALL	T AO L
TAMER	T EY M ER
TAMING	T EY M IH NG
TANK	T AE NG K
TARGET	T AA R G AH T
TARGET(2)	T ER G AH T
TARGET.	T AA R G AH T
TART	T AA R T
TASK	T AE S K
TASK.	T AE S K
TATE,	T EY T
TAUT,	T AO T
TAVERN	T AE V ER N
TAX	T AE K S
TAXES.	T AE K S IH Z
TCHOO-TCHOO	CH UW CH UW
TCHOO-TCHOO-TCHOO.	CH UW CH UW CH UW
TCHOO.	CH UW
TEACH	T IY CH
TEACHER	T IY CH ER
TEACHER,	T IY CH ER
TEACHER.	T IY CH ER
TEACHES	T IY CH AH Z
TEACHES(2)	T IY CH IH Z
TEAM?	T IY M
TEAMWORK.	T IY M W ER K
TEAR	T EH R
TEAR(2)	T IH R
TEASE,	T IY Z
TECHNICALLY,	T EH K N IH K AH L IY
TECHNIQUE	T EH K N IY K
TECHNOLOGY	T EH K N AA L AH JH IY
TEDIOUS	T IY D IY AH S
TEENAGER.	T IY N IH JH ER
TEENAGERS	T IY N EY JH ER Z
TELL	T EH L
TELLING	T EH L IH NG
TEMPORARY	T EH M P ER EH R IY
TEMPTING	T EH M P T IH NG
TEN	T EH N
TEN!	T EH N
TENDENCY	T EH N D AH N S IY
TENSSICA.	T EH N S AH K AH
TENTH.	T EH N TH
TERMINATED.	T ER M AH N EY T IH D
TERRIBLE	T EH R AH B AH L
TERRIBLE.	T EH R AH B AH L
TERRIBLY	T EH R AH B L IY
TERRY	T EH R IY
TERRY'S	T EH R IY Z
TERRY,	T EH R IY
TERRY.	T EH R IY
TEST	T EH S T
TEST,	T EH S T
TESTED	T EH S T IH D
TESTI-MEOW:	T EH S T IY M IY OW
TESTICLES,	T EH S T IH K AH L Z
TESTICLES.	T EH S T IH K AH L Z
TEXT	T EH K S T
TEXTING	T EH K S T IH NG
TEXTS!	T EH K S T S
TH-TH	T IY EY CH T IY EY CH
TH-TH-THAT'S	T IY EY CH T IY EY CH DH AE T S
TH-TH-THESE	T IY EY CH T IY EY CH DH IY Z
TH-THANKS,	T IY EY CH TH AE NG K S
TH-THERE'S	T IY EY CH DH EH R Z
TH-THESE	T IY EY CH DH IY Z
TH-THEY'RE	T IY EY CH DH EH R
THAN	DH AE N
THAN(2)	DH AH N
THANK	TH AE NG K
THANKLESS	TH AE NG K L AH S
THANKS	TH AE NG K S
THANKS!	TH AE NG K S
THANKS,	TH AE NG K S
THANKS.	TH AE NG K S
THANKSGIVING	TH AE NG K S G IH V IH NG
THAT	DH AE T
THAT(2)	DH AH T
THAT!	DH AE T
THAT'LL	DH AE T AH L
THAT'S	DH AE T S
THAT,	DH AE T
THAT.	DH AE T
THAT?	DH AE T
THAT?!	DH AE T
THATFIGHT.	TH AE T AY T
THATISAWESOME!	TH AH T IH S AH S AH M
THE	DH AH
THE(2)	DH IY
THE,	DH AH
THEATERS	TH IY AH T ER Z
THEIR	DH EH R
THEM	DH EH M
THEM(2)	DH AH M
THEM!	DH EH M
THEM,	DH EH M
THEM.	DH EH M
THEM?	DH EH M
THEME	TH IY M
THEMSELVES	DH EH M S EH L V Z
THEMSELVES(2)	DH AH M S EH L V Z
THEN	DH EH N
THEN,	DH EH N
THEN?	DH EH N
THERE	DH EH R
THERE!	DH EH R
THERE'S	DH EH R Z
THERE,	DH EH R
THERE.	DH EH R
THERE?	DH EH R
THEREFORE	DH EH R F AO R
THERMODYNAMICS.	TH ER M AH D AY N AE M IH K S
THESE	DH IY Z
THESE,	DH IY Z
THESE.	DH IY Z
THESE?	DH IY Z
THEY	DH EY
THEY'LL	DH EH L
THEY'RE	DH EH R
THEY'VE	DH EY V
THEY,	DH EY
THI	TH IY
THICKENS.	TH IH K AH N Z
THING	TH IH NG
THING!	TH IH NG
THING'S	TH IH NG Z
THING,	TH IH NG
THING.	TH IH NG
THING?	TH IH NG
THINGS	TH IH NG Z
THINGS,	TH IH NG Z
THINGS.	TH IH NG Z
THINGS:	TH IH NG Z
THINGS?	TH IH NG Z
THINK	TH IH NG K
THINK'S	TH IH NG K S
THINK,	TH IH NG K
THINK.	TH IH NG K
THINK?	TH IH NG K
THINKING	TH IH NG K IH NG
THINKING,	TH IH NG K IH NG
THINKING.	TH IH NG K IH NG
THINKS	TH IH NG K S
THINS.	TH IH N Z
THIRD	TH ER D
THIRTEENTH	TH ER T IY N TH
THIRTY	TH ER D IY
THIRTY,	TH ER T IY
THIS	DH IH S
THIS!	DH IH S
THIS,	DH IH S
THIS.	DH IH S
THIS?	DH IH S
THORN	TH AO R N
THOSE	DH OW Z
THOSE,	DH OW Z
THOSE.	DH OW Z
THOU	DH AW
THOUGH	DH OW
THOUGH,	DH OW
THOUGH.	DH OW
THOUGHT	TH AO T
THOUGHT,	TH AO T
THOUGHT.	TH AO T
THOUGHTS	TH AO T S
THOUGHTS.	TH AO T S
THOUSAND	TH AW Z AH N D
THOUSAND(2)	TH AW Z AH N
THREAD.	TH R EH D
THREATENING	TH R EH T AH N IH NG
THREATENING(2)	TH R EH T N IH NG
THREATS	TH R EH T S
THREE	TH R IY
THREE,	TH R IY
THREE-WAY!	TH R IY W EY
THREE.	TH R IY
THREES	TH R IY Z
THREW	TH R UW
THRIFT	TH R IH F T
THROATS,	TH R OW T S
THRONES.	TH R OW N Z
THROUGH	TH R UW
THROUGH,	TH R UW
THROUGH.	TH R UW
THROW	TH R OW
THROWING	TH R OW IH NG
TICKETMASTER.	T IH K AH T M AE S T ER
TIER	T IY R
TIME	T AY M
TIME!	T AY M
TIME'S	T AY M Z
TIME,	T AY M
TIME-TRAVELING	T AY M T R AE V AH L IH NG
TIME.	T AY M
TIME?	T AY M
TIMELINE	T AY M L AY N
TIMELINE.	T AY M L AY N
TIMELINES	T AY M L AY N Z
TIMELINES,	T AY M L AY N Z
TIMES	T AY M Z
TIMES,	T AY M Z
TIMES.	T AY M Z
TINY	T AY N IY
TINY-PERSONS	T AY N IY P ER S AH N Z
TINY.	T AY N IY
TIRE	T AY ER
TIRED	T AY ER D
TISSUE	T IH S Y UW
TISSUE(2)	T IH SH UW
TO	T UW
TO(2)	T IH
TO(3)	T AH
TO,	T UW
TO.	T UW
TO?	T UW
TOAST	T OW S T
TOAST,	T OW S T
TOASTER	T OW S T ER
TOASTER,	T OW S T ER
TODAY	T AH D EY
TODAY(2)	T UW D EY
TODAY!	T AH D EY
TODAY,	T AH D EY
TODAY.	T AH D EY
TODAY?	T AH D EY
TOGETHER	T AH G EH DH ER
TOGETHER!	T AH G EH DH ER
TOGETHER,	T AH G EH DH ER
TOGETHER.	T AH G EH DH ER
TOGETHER?	T AH G EH DH ER
TOLD	T OW L D
TOM	T AA M
TOM.	T AA M
TOM?	T AA M
TOMATO	T AH M EY T OW
TOMATO(2)	T AH M AA T OW
TOMORROW	T AH M AA R OW
TOMORROW(2)	T UW M AA R OW
TONE.	T OW N
TONIGHT	T AH N AY T
TONIGHT(2)	T UW N AY T
TONIGHT.	T AH N AY T
TOO	T UW
TOO,	T UW
TOO.	T UW
TOO?	T UW
TOOK	T UH K
TOP	T AA P
TOP(2)	T AO P
TOP!	T AA P
TOP.	T AA P
TOPHAT	T AA P HH AE T
TOPS.	T AA P S
TORNADO	T AO R N EY D OW
TOTAL	T OW T AH L
TOTALLY	T OW T AH L IY
TOTALLY.	T OW T AH L IY
TOTES	T OW T S
TOUCH,	T AH CH
TOUCHED	T AH CH T
TOUCHING	T AH CH IH NG
TOUGH	T AH F
TOUGH!	T AH F
TOUH	T UW
TOWN	T AW N
TOWN.	T AW N
TRACK!	T R AE K
TRACT	T R AE K T
TRACT!	T R AE K T
TRADE	T R EY D
TRADITIONALLY	T R AH D IH SH AH N AH L IY
TRADITIONALLY(2)	T R AH D IH SH N AH L IY
TRADITIONS	T R AH D IH SH AH N Z
TRAIL	T R EY L
TRAIN,	T R EY N
TRAIN.	T R EY N
TRAIN?	T R EY N
TRANSFORMED	T R AE N S F AO R M D
TRANSIT	T R AE N Z IH T
TRAPPED	T R AE P T
TRAUMATIZING!	T R AO M AH T AY Z AH NG
TRAVEL	T R AE V AH L
TRAVEL.	T R AE V AH L
TRAVESTY.	T R AE V AH S T IY
TREADMILL,	T R EH D M IH L
TREASON	T R IY Z AH N
TREASURE	T R EH ZH ER
TREASURES!	T R EH ZH ER Z
TREAT	T R IY T
TREATMENT!	T R IY T M AH N T
TREATS	T R IY T S
TREE,	T R IY
TREES	T R IY Z
TREES,	T R IY Z
TREES?	T R IY Z
TRICK	T R IH K
TRICK,	T R IH K
TRICK.	T R IH K
TRIED	T R AY D
TRIES	T R AY Z
TRIMMING	T R IH M IH NG
TRIP	T R IH P
TRIP,	T R IH P
TRIP.	T R IH P
TRIP?	T R IH P
TRIPS	T R IH P S
TROOPER,	T R UW P ER
TROOPS.	T R UW P S
TROUBLE	T R AH B AH L
TROUBLE,	T R AH B AH L
TRUE	T R UW
TRUE,	T R UW
TRUE-TRUE	T R UW T R UW
TRUE-TRUE.	T R UW T R UW
TRUE.	T R UW
TRUNK	T R AH NG K
TRUNKMAN?	T R AH NG K M AE N
TRUNKPEOPLE	T R AH NG K P IY P AH L
TRUNKPEOPLE.	T R AH NG K P IY P AH L
TRUNKPERSON,	T R AH NG K P ER S AH N
TRUST	T R AH S T
TRUTH	T R UW TH
TRUTH,	T R UW TH
TRUTH.	T R UW TH
TRY	T R AY
TRY!	T R AY
TRYING	T R AY IH NG
TRYING(2)	T R AY NG
TRYING!	T R AY IH NG
TUBE	T UW B
TUBE(2)	T Y UW B
TUBERCULOSIS	T AH B ER K Y AH L OW S IH S
TUBERCULOSIS(2)	T UW B ER K Y AH L OW S AH S
TUBERCULOSIS(3)	T UW B ER K Y UW L OW S AH S
TUBERCULOSIS!	T UH B ER K Y AH L OW S AH S
TUGGING	T AH G IH NG
TUNA.	T Y UW N AH
TUNNEL	T AH N AH L
TURBULENT	T ER B Y AH L AH N T
TURD	T AH R D
TURN	T ER N
TURN.	T ER N
TURNED	T ER N D
TURNING	T ER N IH NG
TURNING,	T ER N IH NG
TURNS	T ER N Z
TURQUOISE.	T ER K W OY Z
TV	T IY V IY
TV(2)	T EH L AH V IH ZH AH N
TV,	T IY V IY
TV.	T IY V IY
TV?	T IY V IY
TVS,	T IY V IY EH S
TWAT.	T W AA T
TWELFTH	T W EH L F TH
TWELVE-YEAR-OLD	T W EH L V Y IH R OW L D
TWELVE.	T W EH L V
TWENTY	T W EH N T IY
TWICE	T W AY S
TWILIGHT	T W AY L AY T
TWINKLING	T W IH NG K AH L IH NG
TWINKLING(2)	T W IH NG K L IH NG
TWIST.	T W IH S T
TWO	T UW
TWO,	T UW
TWO.	T UW
TYPE	T AY P
TYPEWRITER	T AY P R AY T ER
U-UH,	Y UW UW
UGH!	AH G
UGH,	AH G
UGH.	AH G
UGLY	AH G L IY
UH	AH
UH,	UW
UH-HUH,	AH HH UW
UH-HUH.	AH HH UW
UH-OH!	AH OW
UH-OH,	AH OW
UH-OH.	AH OW
UH-OH?	AH OW
UH.	UW
UHH	AH
UHH,	AH HH
UHHAT	AH HH AH T
UHHH	AH HH
UHHOKAY.	AH HH AA K EY IY
UHP!	AH P
UHP,	AH P
UHRICK?	AH R AH K
UM	AH M
UM,	AH M
UMM	AH M
UMMI	AH M IY
UMMYOU	AH M AY UW
UMWAIT	AH M W EY T
UN-CURSE	AH N K ER S
UNACCEPTABLE!	AH N AE K S EH P T AH B AH L
UNBELIEVABLE,	AH N B AH L IY V AH B AH L
UNBELIEVABLE.	AH N B AH L IY V AH B AH L
UNCLE,	AH NG K AH L
UNCOMFORTABLE	AH N K AH M F ER T AH B AH L
UNCOMFORTABLE.	AH N K AH M F ER T AH B AH L
UNCONTROLLABLE	AH N K AH N T R OW L AH B AH L
UNDEAD	AH N D EH D
UNDER	AH N D ER
UNDER,	AH N D ER
UNDERAGE	AH N D ER IH JH
UNDERFOOT	AH N D ER F UH T
UNDERRATED	AH N D ER R EY T IH D
UNDERSTAND	AH N D ER S T AE N D
UNDERSTAND.	AH N D ER S T AE N D
UNDERSTOOD.	AH N D ER S T UH D
UNDIES	AH N D AY Z
UNFORESEEABLE	AH N F AO R S IY AH B AH L
UNFREEZE	AH N F R IY Z
UNGLARPING	AH N G L AA R P AH NG
UNH-UNH-UNH,	AH N AH N AH N
UNITED	Y UW N AY T AH D
UNITED(2)	Y UW N AY T IH D
UNIVERSE	Y UW N AH V ER S
UNIVERSE!	Y UW N AH V ER S
UNIVERSE,	Y UW N AH V ER S
UNIVERSE.	Y UW N AH V ER S
UNIVERSES.	Y UW N AH V ER S IH Z
UNKNOWN.	AH N OW N
UNLESS	AH N L EH S
UNLOCKED.	AH N L AA K T
UNMUSCULAR	AH N M AH S K Y AH L ER
UNPROTECTED	AH N P R AH T EH K T IH D
UNREMARKABLE?	AH N R IH M AA R K AH B AH L
UNSPOKEN.	AH N S P OW K AH N
UNTIL	AH N T IH L
UNTOLD	AH N T OW L D
UNTURNED	AH N T ER N D
UNWANTED	AH N W AO N T IH D
UP	AH P
UP!	AH P
UP,	AH P
UP.	AH P
UP?	AH P
UPGRADED	AH P G R EY D AH D
UPGRADED(2)	AH P G R EY D IH D
UPHOLSTERY.	AH P HH OW L S T AH R IY
UPON,	AH P AA N
UPSETTING	AH P S EH T IH NG
UPSTAIRS.	AH P S T AE ER Z
URBAN	ER B AH N
URGENT	ER JH AH N T
URINE	Y ER AH N
URINE(2)	Y UH R AH N
US	AH S
US(2)	Y UW EH S
US!	AH S
US,	AH S
US.	AH S
US?	AH S
US?!	AH S
USE	Y UW S
USE(2)	Y UW Z
USED	Y UW Z D
USELESS.	Y UW S L AH S
USING	Y UW Z IH NG
USUAL,	Y UW ZH AH W AH L
USUALLY	Y UW ZH AH W AH L IY
USUALLY(2)	Y UW ZH AH L IY
USUALLY,	Y UW ZH AH W AH L IY
VACATION!	V EY K EY SH AH N
VAGINA	V AH JH AY N AH
VAGINA,	V AH JH AY N AH
VAGINA.	V AH JH AY N AH
VALENTINE'S	V AE L AH N T AY N Z
VALUABLE	V AE L Y AH B AH L
VALUABLE(2)	V AE L Y UW B AH L
VALUABLE.	V AE L Y UW AH B AH L
VALUED	V AE L Y UW D
VALUES	V AE L Y UW Z
VAN	V AE N
VAN,	V AE N
VAT	V AE T
VEGAN	V EH G AH N
VEHICLE,	V IY IH K AH L
VENTURE	V EH N CH ER
VERDICT,	V ER D IH K T
VERONICA	V ER AA N IH K AH
VERONICA.	V AH R AA N IH K AH
VERONICA?	V AH R AA N IH K AH
VERSION	V ER ZH AH N
VERSIONS	V ER ZH AH N Z
VERY	V EH R IY
VERY,	V EH R IY
VETERINARY	V EH T R AH N EH R IY
VHS	V IY EY CH S
VIBE	V AY B
VICIOUS	V IH SH AH S
VICTIM	V IH K T IH M
VICTORIA'S	V IH K T AO R IY AH Z
VIDEO	V IH D IY OW
VIEW	V Y UW
VILLAGE	V IH L AH JH
VILLAGE(2)	V IH L IH JH
VILLAGE,	V IH L IH JH
VILLAGERS,	V IH L IH JH ER Z
VILLAGERS.	V IH L IH JH ER Z
VINTAGE	V IH N T IH JH
VIOLATION	V AY AH L EY SH AH N
VIOLATION,	V AY AH L EY SH AH N
VIOLATION.	V AY AH L EY SH AH N
VIOLENCE	V AY AH L AH N S
VIOLENT	V AY AH L AH N T
VIOLENTLY	V AY AH L AH N T L IY
VIRTUAL	V ER CH UW AH L
VIRUS.	V AY R AH S
VISCERA	V IH S AH R AH
VISITED	V IH Z IH T IH D
VOICE	V OY S
VOIDS	V OY D Z
VOLE	V OW L
VOLE.	V OW L
VOLES.	V OW L Z
VOLES?	V OW L Z
VOODOO	V UW D UW
VOTE	V OW T
W	D AH B AH L Y UW
W-W	D AH B AH L Y UW D AH B AH L Y UW
W-W-W-W-W	D AH B AH L Y UW D AH B AH L Y UW D AH B AH L Y UW D AH B AH L Y UW D AH B AH L Y UW
W-W-W-W-W-WHAT	D AH B AH L Y UW D AH B AH L Y UW D AH B AH L Y UW D AH B AH L Y UW D AH B AH L Y UW W AH T
W-W-W-W-WE'RE	D AH B AH L Y UW D AH B AH L Y UW D AH B AH L Y UW D AH B AH L Y UW W IY R
W-W-W-W-WHY	D AH B AH L Y UW D AH B AH L Y UW D AH B AH L Y UW D AH B AH L Y UW W AY
W-W-W-WE	D AH B AH L Y UW D AH B AH L Y UW D AH B AH L Y UW W IY
W-W-W-WE'RE	D AH B AH L Y UW D AH B AH L Y UW D AH B AH L Y UW W IY R
W-W-W-WHAT	D AH B AH L Y UW D AH B AH L Y UW D AH B AH L Y UW W AH T
W-W-W-WHEN	D AH B AH L Y UW D AH B AH L Y UW D AH B AH L Y UW W EH N
W-W-W-WHERE	D AH B AH L Y UW D AH B AH L Y UW D AH B AH L Y UW W EH R
W-W-W-WHY	D AH B AH L Y UW D AH B AH L Y UW D AH B AH L Y UW W AY
W-W-WE'RE	D AH B AH L Y UW D AH B AH L Y UW W IY R
W-W-WHAT	D AH B AH L Y UW D AH B AH L Y UW W AH T
W-W-WHAT'S	D AH B AH L Y UW D AH B AH L Y UW W AH T S
W-W-WHEN'S	D AH B AH L Y UW D AH B AH L Y UW W EH N Z
W-W-WHOA,	D AH B AH L Y UW D AH B AH L Y UW W OW
W-W-WHY	D AH B AH L Y UW D AH B AH L Y UW W AY
W-W-WHY?	D AH B AH L Y UW D AH B AH L Y UW W AY
W-WE	D AH B AH L Y UW W IY
W-WE'RE	D AH B AH L Y UW W IY R
W-WELL,	D AH B AH L Y UW W EH L
W-WHAT	D AH B AH L Y UW W AH T
W-WHAT'D	D AH B AH L Y UW W AH T IH D
W-WHAT'S	D AH B AH L Y UW W AH T S
W-WHO?!	D AH B AH L Y UW HH UW
W-WHY	D AH B AH L Y UW W AY
WAFER	W EY F ER
WAISTLINE	W EY S T L AY N
WAIT	W EY T
WAIT!	W EY T
WAIT,	W EY T
WAIT.	W EY T
WAITER?	W EY T ER
WAKE	W EY K
WAKE-UP	W EY K AH P
WAKES	W EY K S
WALK	W AO K
WALK(2)	W AA K
WALK.	W AO K
WALKING	W AO K IH NG
WALKS!	W AO K S
WALL	W AO L
WALNUT	W AO L N AH T
WANDERS	W AA N D ER Z
WANNA	W AA N AH
WANT	W AA N T
WANT(2)	W AO N T
WANT,	W AO N T
WANT.	W AO N T
WANT?	W AO N T
WANTED	W AO N T IH D
WANTED,	W AO N T IH D
WANTED.	W AO N T IH D
WANTED?	W AO N T IH D
WANTING	W AA N T IH NG
WANTING(2)	W AA N IH NG
WANTS	W AA N T S
WANTS(2)	W AO N T S
WANTS!	W AO N T S
WANTS?	W AO N T S
WAR,	W AO R
WAS	W AA Z
WAS,	W AH Z
WAS.	W AH Z
WAS?	W AH Z
WASH.	W AA SH
WASHING	W AA SH IH NG
WASN'T	W AA Z AH N T
WASN'T(2)	W AH Z AH N T
WASTE	W EY S T
WASTE.	W EY S T
WATCH	W AA CH
WATCH(2)	W AO CH
WATCH.	W AA CH
WATCHING	W AA CH IH NG
WATER	W AO T ER
WATER.	W AO T ER
WAX	W AE K S
WAY	W EY
WAY,	W EY
WAY.	W EY
WAY?	W EY
WAYS	W EY Z
WAYS?	W EY Z
WAYSIDE.	W EY S AY D
WE	W IY
WE'D	W IY D
WE'LL	W IY L
WE'LL(2)	W IH L
WE'RE	W IY R
WE'RE(2)	W IH R
WE'RE(3)	W ER
WE'VE	W IY V
WE.	W IY
WEAK,	W IY K
WEALTHIER	W EH L TH IY ER
WEAPON,	W EH P AH N
WEAPONS	W EH P AH N Z
WEAPONS?!	W EH P AH N Z
WEAR	W EH R
WEARING	W EH R IH NG
WEATHER	W EH DH ER
WEB	W EH B
WEBSITE,	W EH B S AY T
WEDDING	W EH D IH NG
WEEK	W IY K
WEEK!	W IY K
WEEK,	W IY K
WEEK.	W IY K
WEEKEND	W IY K EH N D
WEEKEND(2)	W IY K IH N D
WEEKEND.	W IY K EH N D
WEEKENDS.	W IY K EH N D Z
WEEP,	W IY P
WEIRD	W IH R D
WEIRD,	W IH ER D
WEIRD.	W IH ER D
WEIRD?	W IH ER D
WEIRDER,	W IH ER D ER
WELCOME	W EH L K AH M
WELCOME,	W EH L K AH M
WELCOME.	W EH L K AH M
WELL	W EH L
WELL,	W EH L
WELL.	W EH L
WELLI	W EH L IY
WENT	W EH N T
WERE	W ER
WERE,	W ER
WERE.	W ER
WEREN'T	W ER AH N T
WEREN'T(2)	W ER N T
WEREUH,	W IY R UW
WEREWOLF.	W EH R UW OW L F
WEST	W EH S T
WH	D AH B AH L Y UW
WH-WHAT?	D AH B AH L Y UW W AA T
WH-WHERE'S	D AH B AH L Y UW W EH R Z
WHA	W AA
WHA-WHAT	W AA W AH T
WHA?	W AA
WHAT	W AH T
WHAT(2)	HH W AH T
WHAT'D	W AH T IH D
WHAT'D(2)	HH W AH T IH D
WHAT'S	W AH T S
WHAT'S(2)	HH W AH T S
WHAT,	W AA T
WHAT.	W AA T
WHAT?	W AA T
WHAT?!	W AA T
WHAT?A	W AA T AH
WHATCHA	W AA CH AH
WHATEVER	W AH T EH V ER
WHATEVER(2)	HH W AH T EH V ER
WHATEVER'S	W AH T EH V ER Z
WHATEVER'S(2)	HH W AH T EH V ER Z
WHATEVER,	W AA T EH V ER
WHATEVER.	W AA T EH V ER
WHEAT	W IY T
WHEAT(2)	HH W IY T
WHEEL.	W IY L
WHEELS?	W IY L Z
WHEN	W EH N
WHEN(2)	HH W EH N
WHEN(3)	W IH N
WHEN(4)	HH W IH N
WHERE	W EH R
WHERE(2)	HH W EH R
WHERE'D	W EH R D
WHERE'D(2)	HH W EH R D
WHERE'S	W EH R Z
WHERE'S(2)	HH W EH R Z
WHEREABOUTS	W EH R AH B AW T S
WHEREABOUTS(2)	HH W EH R AH B AW T S
WHEREVER	W EH R EH V ER
WHEREVER(2)	HH W EH R EH V ER
WHEW!	W UW
WHICH	W IH CH
WHICH(2)	HH W IH CH
WHILE	W AY L
WHILE(2)	HH W AY L
WHILE.	W AY L
WHIMSICAL	W IH M Z IH K AH L
WHIMSICAL(2)	HH W IH M Z IH K AH L
WHIP	W IH P
WHIP(2)	HH W IH P
WHIPPED	W IH P T
WHIPPED(2)	HH W IH P T
WHISKEY?	W IH S K IY
WHITE	W AY T
WHITE(2)	HH W AY T
WHITE,	W AY T
WHITE-GUILT	W AY T G IH L T
WHITE.	W AY T
WHITENESS	W AY T N AH S
WHITENESS(2)	HH W AY T N AH S
WHITENESS.	W AY T N AH S
WHITEWASH	W AY T W AA SH
WHITEWASH(2)	HH W AY T W AA SH
WHO	HH UW
WHO'S	HH UW Z
WHOA!	W OW
WHOA,	W OW
WHOA-HO-HO!	W OW HH OW HH OW
WHOA.	W OW
WHOAAAA!	W OW AH AH
WHOEVER	HH UW EH V ER
WHOLE	HH OW L
WHOLESOME	HH OW L S AH M
WHOO!	W UW
WHOO,	W UW
WHOOOOOO!	W UW UW UW
WHOOP!	W UW P
WHOOP-DE-DO.	W UW P D IY D UW
WHOOPS.	W UW P S
WHOOPSIE!	W UW P S IY
WHOOPSIE.	W UW P S IY
WHOSE	HH UW Z
WHY	W AY
WHY(2)	HH W AY
WHY,	W AY
WHY?	W AY
WIDE	W AY D
WIDE-EYED	W AY D AY D
WIENER	W IY N ER
WIENER(2)	W AY N ER
WIENER?	W IY N ER
WIFE	W AY F
WIFE!	W AY F
WIFE.	W AY F
WIFE?	W AY F
WILD	W AY L D
WILD,	W AY L D
WILL	W IH L
WILL(2)	W AH L
WILL?	W IH L
WILLIAMS-SONOMA?	W IH L Y AH M Z S AA N AH M AH
WILLING	W IH L IH NG
WIN	W IH N
WIN!	W IH N
WIN,	W IH N
WIN.	W IH N
WINDOW	W IH N D OW
WINDOWS!	W IH N D OW Z
WINE	W AY N
WINE?	W AY N
WINNING	W IH N IH NG
WISH	W IH SH
WISH!	W IH SH
WISH,	W IH SH
WITH	W IH DH
WITH(2)	W IH TH
WITH,	W IH TH
WITH.	W IH TH
WITHIN	W IH DH IH N
WITHIN(2)	W IH TH IH N
WITHOUT	W IH TH AW T
WITHOUT(2)	W IH DH AW T
WOBBLE	W AA B AH L
WOLF	W UH L F
WOMAN!	W UH M AH N
WOMAN,	W UH M AH N
WOMAN.	W UH M AH N
WOMANKIND	W UH M AH N K AY N D
WOMEN	W IH M AH N
WOMEN.	W IH M AH N
WOMEN?	W IH M AH N
WON	W AH N
WON(2)	W AA N
WON'T	W OW N T
WON'T.	W OW N T
WONDER	W AH N D ER
WONDER,	W AH N D ER
WONDER.	W AH N D ER
WONDERED,	W AH N D ER D
WONDERFUL	W AH N D ER F AH L
WONDERFUL.	W AH N D ER F AH L
WONDERING	W AH N D ER IH NG
WONDERING,	W AH N D ER IH NG
WORD	W ER D
WORD,	W ER D
WORD.	W ER D
WORDPLAY	W ER D P L EY
WORDS.	W ER D Z
WORDS?	W ER D Z
WORK	W ER K
WORK,	W ER K
WORK.	W ER K
WORK?	W ER K
WORKED	W ER K T
WORKED.	W ER K T
WORKING	W ER K IH NG
WORKING.	W ER K IH NG
WORKS,	W ER K S
WORKS.	W ER K S
WORKS?	W ER K S
WORKSHOP	W ER K SH AA P
WORLD	W ER L D
WORLD'S	W ER L D Z
WORLD,	W ER L D
WORLD.	W ER L D
WORMHOLES	W ER M HH AO L Z
WORRIED	W ER IY D
WORRY	W ER IY
WORRY,	W ER IY
WORST	W ER S T
WORST!	W ER S T
WORST-CASE	W ER S T K EY S
WORST.	W ER S T
WORTH,	W ER TH
WORTHLESS.	W ER TH L AH S
WOULD	W UH D
WOULDN'T	W UH D AH N T
WOW!	W AW
WOW,	W AW
WOW.	W AW
WRAP	R AE P
WRAPPED	R AE P T
WRITES	R AY T S
WRITING	R AY T IH NG
WRITTEN	R IH T AH N
WRONG	R AO NG
WRONG,	R AO NG
WRONG.	R AO NG
WRONG?	R AO NG
WROTE	R OW T
WUBBA	W AH B AH
WUBBA-LUBBA-DUB-DUB!	W AH B AH L AH B AH D AH B D AH B
WUBBA-LUBBA-DUB-DUBS!	W AH B AH L AH B AH D AH B D AH B Z
WUBBA-LUBBA-DUB-DUBS?	W AH B AH L AH B AH D AH B D AH B Z
WWW	D AH B AH L Y UW D AH B AH L Y UW W
X	EH K S
XANTHANITE?	Z AE N TH AH N AY T
XENON	Z IY N AA N
XL.	EH K S EH L
XW2.	EH K S D AH B AH L Y UW T UW
Y	W AY
Y'ALL	Y AO L
Y-Y	W AY W AY
Y-Y-Y-Y-Y-YOU'RE	W AY W AY W AY W AY W AY Y UH R
Y-Y-Y-Y-YOU'RE	W AY W AY W AY W AY Y UH R
Y-Y-Y-YOU	W AY W AY W AY Y UW
Y-Y-YOU	W AY W AY Y UW
Y-Y-YOU'LL	W AY W AY Y UW L
Y-Y-YOU'RE	W AY W AY Y UH R
Y-YOU	W AY Y UW
Y-YOU'RE	W AY Y UH R
Y-YOU'VE	W AY Y UW V
YA	Y AA
YA,	Y AA
YACHT,	Y AA T
YAHTZEE!	Y AE T S IY IY
YAHTZEE'S	Y AE T S IY Z
YAHTZEE.	Y AE T S IY IY
YARDS	Y AA R D Z
YAY!	Y EY IY
YAY,	Y EY IY
YEAH	Y AE
YEAH!	Y IY
YEAH,	Y IY
YEAH.	Y IY
YEAH?	Y IY
YEAR	Y IH R
YEAR!	Y IH ER
YEAR,	Y IH ER
YEARS	Y IH R Z
YEARS,	Y IH ER Z
YEARS.	Y IH ER Z
YELLER.	Y EH L ER
YELLING	Y EH L IH NG
YEP.	Y EH P
YES	Y EH S
YES!	Y EH S
YES,	Y EH S
YES.	Y EH S
YES?	Y EH S
YET	Y EH T
YET.	Y EH T
YO,	Y OW
YO.	Y OW
YORK	Y AO R K
YORK.	Y AO R K
YOU	Y UW
YOU!	Y UW
YOU'D	Y UW D
YOU'D(2)	Y UH D
YOU'LL	Y UW L
YOU'RE	Y UH R
YOU'RE(2)	Y UW R
YOU'VE	Y UW V
YOU,	Y UW
YOU.	Y UW
YOU?	Y UW
YOU?!	Y UW
YOUNG	Y AH NG
YOUNG,	Y AH NG
YOUNG.	Y AH NG
YOUR	Y AO R
YOUR(2)	Y UH R
YOURPARENTS?	Y AH R P AH R AH N T S
YOURS.	Y UH R Z
YOURSELF	Y ER S EH L F
YOURSELF(2)	Y UH R S EH L F
YOURSELF(3)	Y AO R S EH L F
YOURSELF!	Y ER S EH L F
YOURSELF,	Y ER S EH L F
YOURSELF.	Y ER S EH L F
YOURSELF?!	Y ER S EH L F
YOURSELVES	Y UH R S EH L V Z
YOURSELVES(2)	Y AO R S EH L V Z
YOUTH	Y UW TH
ZACK	Z AE K
ZEROS	Z IH R OW Z
ZIGERION	Z AH JH IY R IY AH N
ZIGERIONS	Z AH JH IY R IY AH N Z
ZONE	Z OW N
ZONE,	Z OW N
ZUCKERBERG'S	Z AH K ER B ER G Z
ZUCKERBERG-ING	Z AH K ER B ER G IH NG
